border_size=1
usage=map

Xu          , Xu          , Xu          , Xu          , Xu          , Xu          , Xu          , Xu          , Xu          , Xu          , Xu          , Xu          , Xu          , Xu          , Xu          , Xu          , Xu          , Xu          , Xu          , Xu          , Xu          , Xu          
Xu          , Xu          , Xu          , Xu          , Xu          , Xu          , Xu          , Xu          , Xu          , Xu          , Xu          , Xu          , Xu          , Xu          , Xu          , Xu          , Xu          , Xu          , Xu          , Xu          , Xu          , Xu          
Xu          , Xu          , Chr         , Chr         , 2 Khr       , Chr         , Chr         , Xu          , Chr         , Xu          , Uu          , Xu          , Xu          , Xu          , Xu          , Xu          , Uu          , Xu          , Uh          , Xu          , Xu          , Xu          
Xu          , Xu          , Uu          , Chr         , Chr         , Chr         , Uu          , Uu          , Xu          , Uu          , Uu^Uf       , Uu          , Uu          , Uu          , Uu          , Uu          , Xu          , Uu          , Uh          , Uh          , Xu          , Xu          
Xu          , Xu          , Xu          , Uu          , Uu          , Chr         , Xu          , Xu          , Uu          , Xu          , Xu          , Uu          , Xu          , Xu          , Xu          , Xu          , Uu^Vu       , Xu          , Xu          , Uu          , Xu          , Xu          
Xu          , Xu          , Uu          , Chr         , Xu          , Xu          , Rr          , Rr          , Xu          , Rr          , Uu          , Uu          , Rr          , Uu          , Uu          , Xu          , Uu          , Xu          , Uu          , Uu          , Xu          , Xu          
Xu          , Uu          , Xu          , Xu          , Xu          , Uu          , Uu          , Xu          , Uu^Vud      , Xu          , Xu          , Xu          , Xu          , Rr          , Uu          , Xu          , Uu          , Uu          , Uu          , Uu          , Uu          , Xu          
Xu          , Uu          , Uu          , Uu          , Uu          , Rr          , Xu          , Uu          , Uu^Ii       , Xu          , Xu          , Uu^Vu       , Uu          , Xu          , Rr          , Xu          , Xu          , Xu          , Uu          , Uu          , Uu          , Xu          
Xu          , Xu          , Uh          , Xu          , Uu          , Uu          , Rr          , Xu          , Uh          , Rr          , Uu^Ii       , Xu          , Uu          , Xu          , Rr          , Uu          , Uu          , Xu          , Uu          , Uu          , Uu          , Xu          
Xu          , Xu          , Uh          , Xu          , Uu          , Uu          , Xu          , Rr          , Uu          , Xu          , Uu^Ii       , Xu          , Xu          , Uu          , Xu          , Uu          , Rr          , Xu          , Uu          , Uu^Uf       , Uu^Uf       , Xu          
Xu          , Xu          , Uh          , Xu          , Uu          , Xu          , Uu^Vu       , Xu          , Uu          , Xu          , Uu^Uf       , Xu          , Uu          , Uu^Uf       , Xu          , Uu          , Rr          , Uu          , Uu          , Uu^Uf       , Uu          , Xu          
Xu          , Xu          , Xu          , Uu          , Uu          , Xu          , Uu          , Xu          , Rr          , Xu          , Uu          , Uu          , Xu          , Uu          , Xu          , Xu          , Rr          , Xu          , Uu          , Uh          , Uu          , Xu          
Xu          , Xu          , Uu^Uf       , Xu          , Uu          , Xu          , Uu          , Xu          , Rr          , Xu          , Xu          , Rr          , Xu          , Uu^Vu       , Xu          , Xu          , Uu          , Xu          , Uu          , Uh          , Uu          , Xu          
Xu          , Xu          , Xu          , Uu          , Uu          , Xu          , Uu          , Uh          , Rr          , Uu          , Uu          , Rr          , Xu          , Xu          , Rr          , Rr          , Xu          , Xu          , Uu          , Uu          , Uu          , Xu          
Xu          , Xu          , Xu          , Uh          , Uu          , Uu          , Uu          , Xu          , Uu          , Xu          , Xu          , Uu          , Rr          , Xu          , Uu          , Xu          , Uu          , Xu          , Uu          , Uu          , Xu          , Xu          
Xu          , Xu          , Uu          , Uu          , Xu          , Xu          , Uu          , Xu          , Rr          , Uu^Uf       , Xu          , Xu          , Uu^Vu       , Rr          , Xu          , Uu          , Uu          , Xu          , Xu          , Uu          , Xu          , Xu          
Xu          , Uu          , Xu          , Xu          , Uu^Vu       , Uu          , Xu          , Xu          , Uu^Ii       , Xu          , Xu          , Xu          , Xu          , Xu          , Xu          , Uu          , Xu          , Xu          , Uu          , Uu          , Xu          , Xu          
Xu          , Uu          , Uu^Uf       , Xu          , Xu          , Uu          , Uu          , Uu          , Uu          , Uu          , Rr          , Uu          , Uu          , Xu          , Uu          , Uu          , Uu          , Uu          , Xu          , Xu          , Xu          , Xu          
Xu          , Xu          , Uu          , Xu          , Uu          , Uu          , Xu          , Xu          , Uu          , Uu          , Xu          , Rr          , Rr          , Uu          , Uu          , Xu          , Xu          , Xu          , Uu^Uf       , Uu^Vu       , Xu          , Xu          
Xu          , Xu          , Xu          , Uu          , Uh          , Xu          , Uu          , Uu          , Uh          , Uu          , Uu          , Xu          , Xu          , Rr          , Rr          , Uu          , Uu          , Uu          , Uu          , Uu          , Xu          , Xu          
Xu          , Xu          , Xu          , Xu          , Xu          , Uu          , Uu          , Uu          , Uu^Uf       , Uu          , Xu          , Uu          , Uu^Vu       , Xu          , Xu          , Rr          , Rr          , Uu          , Rr          , 1 Uu        , Uu          , Xu          
Xu          , Xu          , Xu          , Xu          , Xu          , Xu          , Xu          , Xu          , Xu          , Xu          , Xu          , Xu          , Xu          , Xu          , Xu          , Xu          , Xu          , Xu          , Xu          , Xu          , Xu          , Xu          
