border_size=1
usage=map

Xu          , Xu          , Xu          , Xu          , Xu          , Xu          , Xu          , Xu          , Xu          , Xu          , Xu          , Xu          , Xu          , Xu          , Xu          , Qxu         , Qxu         , Qxu         , Qxu         , Qxu         , Qxu         , Qxu         , Qxu         , Qxu         , Qxu         , Xu          , Xu          , Xu          , Xu          , Xu          , Xu          , Xu          , Xu          , Xu          , Xu          , Xu          , Xu          
Xu          , Xu          , Xu          , Xu          , Xu          , Xu          , Xu          , Xu          , Xu          , Xu          , Xu          , Xu          , Xu          , Xu          , Xu          , Qxu         , Qxu         , Qxu         , Qxu         , Qxu         , Qxu         , Qxu         , Qxu         , Qxu         , Qxu         , Xu          , Xu          , Xu          , Xu          , Xu          , Xu          , Xu          , Xu          , Xu          , Xu          , Xu          , Xu          
Xu          , Xu          , Xu          , Xu          , Xu          , Xu          , Xu          , Xu          , Xu          , Xu          , Xu          , Xu          , Xu          , Xu          , Xu          , Qxu         , Qxu         , Qxu         , Qxu         , Qxu         , Uu          , Qxu         , Qxu         , Qxu         , Uu          , Uu^Uf       , Uu^Uf       , Xu          , Uu^Uf       , Xu          , Xu          , Xu          , Xu          , Xu          , Xu          , Xu          , Xu          
Xu          , Xu          , Xu          , Xu          , Xu          , Xu          , Xu          , Xu          , Xu          , Xu          , Xu          , Uu^Uf       , Uu          , Uu^Uf       , Uu          , Uu^Uf       , Uu          , Uu          , Uu          , Uu          , Uu          , Uu          , Uu          , Uu          , Ur          , Ur          , Ur          , Ur          , Ur          , Uu^Uf       , Uu^Uf       , Xu          , Xu          , Xu          , Xu          , Xu          , Xu          
Xu          , Xu          , Xu          , Xu          , Xu          , Xu          , Xu          , Xu          , Uu          , Qxu         , Uu          , Uu          , Uu          , Uu          , Uu          , Uu          , Xu          , Uu          , Uu          , Uu          , Ur          , Re          , Ur          , Ur          , Uu          , Ur          , Rp          , Ur          , Ur          , Uu          , Uu          , Uu^Uf       , Uu^Uf       , Xu          , Xu          , Xu          , Xu          
Xu          , Xu          , Xu          , Xu          , Xu          , Xu          , Uu          , Uu          , Ur          , Uu          , Uh          , Xu          , Xu          , Xu          , Xu          , Xu          , Xu          , Xu          , Re          , Re          , Ur          , Ur          , Xu          , Xu          , Uu          , Rp          , Re          , Rp          , Uu          , Ur          , Ur          , Uu          , Uu^Uf       , Xu          , Xu          , Xu          , Xu          
Xu          , Xu          , Xu          , Xu          , Uu^Uf       , Uu          , Uu          , Uu          , Uu          , Ur          , Ur          , Xu          , Ur          , Uu          , Rp          , Rp          , Rp          , Rp          , Rp          , Rp          , Uu^Uf       , Uu          , Xu          , Xu          , Uu          , Uu          , Uu          , Uu          , Xu          , Uu          , Ur          , Uu          , Uu^Uf       , Xu          , Xu          , Xu          , Xu          
Xu          , Xu          , Xu          , Xu          , Uu          , Uu          , Uu          , Uu          , Xu          , Xu          , Uu          , Ur          , Uu          , Rp          , Rp          , Rp          , Rp          , Rp          , Uu^Uf       , Uu^Uf       , Uu^Uf       , Xu          , Xu          , Xu          , Uu          , Uu^Vu       , Uu          , Uu          , Xu          , Uu          , Ur          , Ur          , Uu          , Xu          , Xu          , Xu          , Xu          
Xu          , Xu          , Xu          , Uu^Uf       , Ur          , Uu          , Uh          , Xu          , Xu          , Xu          , Uu          , Xu          , Ur          , Ur          , Re          , Re          , Re          , Rp          , Uu^Uf       , Uu^Uf       , Uu^Uf       , Xu          , Xu          , Xu          , Xu          , Uu          , Xu          , Xu          , Xu          , Xu          , Ur          , Uu          , Uu          , Xu          , Xu          , Xu          , Xu          
Xu          , Xu          , Uu^Uf       , Uu          , Ur          , Uu          , Xu          , Xu          , Xu          , Uh          , Uu          , Uu          , Ur          , Xu          , Re          , Uu          , Uu          , Re          , Re          , Uu^Uf       , Uu          , Uu          , Xu          , Xu          , Xu          , Xu          , Xu          , Xu          , Xu          , Xu          , Ur          , Ur          , Uu          , Xu          , Xu          , Xu          , Xu          
Xu          , Xu          , Uu          , Ur          , Ur          , Uu          , Xu          , Xu          , Xu          , Uu          , Ur          , Ur          , Uu          , Xu          , Uu          , Xu          , Uu^Uf       , Uu          , Ur          , Re          , Re          , Uu          , Uu          , Uh          , Xu          , Uh          , Uu          , Xu          , Xu          , Xu          , Ur          , Ur          , Uu          , Xu          , Xu          , Xu          , Xu          
Xu          , Xu          , Uu          , Uu          , Ur          , Uh          , Xu          , Xu          , Uh          , Uu          , Ur          , Uu          , Xu          , Xu          , Xu          , Xu          , Xu          , Uu          , Uu          , Ur          , Re          , Rp          , Uu          , Uu          , Uu          , Uu          , Uu          , Uu          , Xu          , Xu          , Uu          , Ur          , Uu          , Xu          , Xu          , Xu          , Xu          
Xu          , Uu^Uf       , Uu^Uf       , Ur          , Ur          , Xu          , Xu          , Xu          , Uu          , Uu          , Ur          , Uu          , Xu          , Xu          , Xu          , Qxu         , Xu          , Uu          , Uu          , Ur          , Rp          , Rp          , Xu          , Xu          , Xu          , Uu          , Ur          , Uu          , Uu          , Xu          , Uu          , Ur          , Uu          , Xu          , Xu          , Xu          , Xu          
Xu          , Uu^Uf       , Uu^Uf       , Ur          , Ur          , Xu          , Xu          , Uh          , Re          , Re          , Uu          , Xu          , Xu          , Xu          , Xu          , Uu          , Ur          , Uu          , Uu          , Uu          , Rp          , Rp          , Rp          , Uu          , Uu          , Xu          , Uu          , Ur          , Ur          , Ur          , Ur          , Ur          , Ur          , Uh          , Xu          , Xu          , Xu          
Xu          , Uu^Uf       , Uu          , Uu          , Rp          , Xu          , Re          , Re          , Uu          , Uu          , Xu          , Xu          , Xu          , Xu          , Xu          , Ur          , Uu          , Xu          , Xu          , Uu          , Re          , Re          , Uu          , Uu          , Uu          , Uu          , Xu          , Uu          , Uu          , Uu          , Uu          , Uu          , Ur          , Uu          , Xu          , Xu          , Xu          
Xu          , Xu          , Ur          , Ur          , Xu          , Rp          , Uu          , Uu          , Uu          , Uu          , Xu          , Xu          , Xu          , Xu          , Xu          , Ur          , Ur          , Uu          , Xu          , Uu          , Re          , Uu          , Uu          , Xu          , Xu          , Xu          , Xu          , Xu          , Xu          , Xu          , Xu          , Uu          , Ur          , Uu          , Uh          , Xu          , Xu          
Xu          , Xu          , Ur          , Xu          , Xu          , Uu          , Uu          , Uu          , Xu          , Xu          , Xu          , Xu          , Xu          , Xu          , Xu          , Xu          , Ur          , Ur          , Cud         , Rr          , Re          , Uu          , Uu          , Xu          , Xu          , Xu          , Xu          , Xu          , Xu          , Xu          , Ur          , Ur          , Uu^Uf       , Uu^Uf       , Uu^Uf       , Xu          , Xu          
Xu          , Xu          , Ur          , Xu          , Uu^Uf       , Uu          , Xu          , Re          , Re          , Uh          , Uh          , Uu          , Uu          , Uu          , Uu          , Uu          , Rr          , Rr          , Rr          , Rr          , Rr          , Uu          , Uu^Uf       , Uu          , Xu          , Xu          , Xu          , Xu          , Uu          , Uu          , Ur          , Uu^Uf       , Uu^Uf       , Uu^Uf       , Uu^Uf       , Xu          , Xu          
Xu          , Xu          , Ur          , Uu          , Xu          , Uu          , Xu          , Xu          , Xu          , Uu          , Uu          , Xu          , Rp          , Uu          , Rr          , Rr          , Rr          , Rr          , Rr          , Rr          , Rr          , Rr          , Uu          , Uu          , Uu          , Uh          , Xu          , Uu          , Ur          , Ur          , Ur          , Uu^Uf       , Ur          , Uu^Uf       , Uu^Uf       , Xu          , Xu          
Xu          , Xu          , Uu          , Ur          , Uu          , Uu          , Xu          , Xu          , Xu          , Uu          , Xu          , Xu          , Rp          , Uu          , Cud         , Rr          , Rr          , Rr          , Rr          , Rr          , Rr          , Rr          , Cud         , Uu          , Xu          , Uu          , Uu^Uf       , Ur          , Uu          , Uu          , Xu          , Ur          , Ur          , Uu          , Uu          , Xu          , Xu          
Xu          , Xu          , Uu          , Ur          , Ur          , Uu          , Xu          , Xu          , Xu          , Ur          , Ur          , Re          , Rp          , Xu          , Rr          , Rr          , Rr          , Rr          , Rr          , Rr          , Rr          , Rr          , Rr          , Uu          , Xu          , Re          , Uu          , Xu          , Xu          , Xu          , Xu          , Xu          , Ur          , Uu          , Uu          , Xu          , Xu          
Xu          , Xu          , Xu          , Uu          , Ur          , Ur          , Ur          , Xu          , Re          , Ur          , Uu          , Re          , Rp          , Xu          , Uu          , Rr          , Rr          , Rr          , Rr          , Rr          , Rr          , Rr          , Rr          , Uu          , Uu          , Rp          , Uu          , Xu          , Xu          , Xu          , Xu          , Ur          , Uu          , Uu          , Uh          , Xu          , Xu          
Xu          , Xu          , Xu          , Uu          , Uu          , Ur          , Uu          , Re          , Xu          , Ur          , Xu          , Xu          , Rp          , Uu^Uf       , Xu          , Xu          , Uu          , Rr          , Uu          , Rr          , Uu          , Xu          , Rr          , Xu          , Uu          , Rp          , Uu          , Xu          , Xu          , Xu          , Uu          , Ur          , Uu          , Uu          , Xu          , Xu          , Xu          
Xu          , Xu          , Xu          , Xu          , Uu          , Ur          , Uu          , Xu          , Xu          , Ur          , Xu          , Xu          , Rp          , Uu          , Xu          , Uu^Vu       , Xu          , Xu          , Uh          , Rp          , Uu          , Xu          , Xu          , Xu          , Re          , Rp          , Uu          , Xu          , Xu          , Xu          , Ur          , Ur          , Uu          , Uh          , Xu          , Xu          , Xu          
Xu          , Xu          , Xu          , Uu          , Uh          , Ur          , Ur          , Uu          , Xu          , Uu          , Uu          , Rp          , Rp          , Xu          , Xu          , Uu          , Xu          , Uu          , Uh          , Rp          , Xu          , Uu^Vu       , Xu          , Xu          , Rp          , Uh          , Uh          , Xu          , Xu          , Uu          , Ur          , Uu          , Uh          , Xu          , Xu          , Xu          , Xu          
Xu          , Xu          , Xu          , Uu          , Uu          , Uu          , Ur          , Uu          , Xu          , Uu^Uf       , Uu          , Rp          , Rp          , Xu          , Xu          , Uu          , Uu          , Uu          , Rp          , Xu          , Uu          , Uu          , Xu          , Xu          , Ur          , Uh          , Uu          , Xu          , Ur          , Ur          , Uu          , Uu          , Xu          , Xu          , Xu          , Xu          , Xu          
Xu          , Xu          , Xu          , Uu          , Uu^Uf       , Uu          , Ur          , Xu          , Xu          , Uu          , Uu          , Rp          , Xu          , Uh          , Uh          , Xu          , Rp          , Xu          , Xu          , Xu          , Xu          , Re          , Xu          , Xu          , Ur          , Ur          , Uu          , Ur          , Ur          , Ur          , Uu          , Uu          , Xu          , Xu          , Xu          , Xu          , Xu          
Xu          , Xu          , Xu          , Uu^Uf       , Uu          , Uh          , Ur          , Xu          , Xu          , Uu          , Uu          , Rp          , Xu          , Uh          , Uh          , Xu          , Rp          , Xu          , Xu          , Rp          , Rp          , Xu          , Xu          , Xu          , Uu          , Ur          , Ur          , Ur          , Uu          , Uu          , Xu          , Xu          , Xu          , Xu          , Xu          , Xu          , Xu          
Xu          , Xu          , Xu          , Xu          , Uu          , Uu          , Ur          , Xu          , Xu          , Ur          , Uu          , 1 Uu        , Rp          , Xu          , Xu          , Uu          , Rp          , Xu          , Re          , Uu          , Xu          , Xu          , Xu          , Uu          , Ur          , Ur          , Uu          , Uu          , Uu          , Uu          , Xu          , Xu          , Xu          , Xu          , Xu          , Xu          , Xu          
Xu          , Xu          , Xu          , Xu          , Uu          , Uu          , Uu          , Ur          , Ur          , Re          , Uu          , Uh          , Uu          , Uu          , Xu          , Uu          , Xu          , Xu          , Xu          , Uu          , Ur          , Ur          , Uu          , Re          , Re          , Uu          , Uh          , Xu          , Xu          , Xu          , Xu          , Xu          , Xu          , Xu          , Xu          , Xu          , Xu          
Xu          , Xu          , Xu          , Xu          , Xu          , Uu          , Uu          , Uu          , Uu          , Ur          , Xu          , Xu          , Uh          , Uu          , Rp          , Rp          , Xu          , Uu          , Rp          , Rp          , Uu          , Uu          , Uu          , Uu          , Uu          , Uu^Uf       , Xu          , Xu          , Xu          , Xu          , Xu          , Xu          , Xu          , Xu          , Xu          , Xu          , Xu          
Xu          , Xu          , Xu          , Xu          , Xu          , Uu          , Uu          , Uu          , Uu          , Ur          , Ur          , Rp          , Uh          , Uu          , Rp          , Ur          , Uu          , Rp          , Rp          , Xu          , Xu          , Uu          , Uu          , Uu          , Uu          , Xu          , Xu          , Xu          , Xu          , Xu          , Xu          , Xu          , Xu          , Xu          , Xu          , Xu          , Xu          
Xu          , Xu          , Xu          , Xu          , Xu          , Xu          , Xu          , Uu^Uf       , Xu          , Xu          , Uu          , Rp          , Ur          , Xu          , Xu          , Ur          , Uh          , Rp          , Xu          , Ur          , Xu          , Uu          , Uu          , Uh          , Xu          , Xu          , Xu          , Xu          , Xu          , Xu          , Xu          , Xu          , Xu          , Xu          , Xu          , Xu          , Xu          
Xu          , Xu          , Xu          , Xu          , Xu          , Xu          , Xu          , Xu          , Xu          , Xu          , Uu          , Uu          , Uu          , Ur          , Xu          , Ur          , Ur          , Rp          , Ur          , Ur          , Uu          , Uu          , Uh          , Xu          , Xu          , Xu          , Xu          , Xu          , Xu          , Xu          , Xu          , Xu          , Xu          , Xu          , Xu          , Xu          , Xu          
Xu          , Xu          , Xu          , Xu          , Xu          , Xu          , Xu          , Xu          , Xu          , Xu          , Uh          , Uh          , Uu          , Ur          , Ce          , Ce          , Ce          , Ce          , Ce          , Xu          , Uu^Uf       , Xu          , Xu          , Xu          , Xu          , Xu          , Xu          , Xu          , Xu          , Xu          , Xu          , Xu          , Xu          , Xu          , Xu          , Xu          , Xu          
Xu          , Xu          , Xu          , Xu          , Xu          , Xu          , Xu          , Xu          , Xu          , Xu          , Xu          , Xu          , Xu          , Xu          , Uu^Uf       , Ce          , 2 Ke        , Ce          , Xu          , Xu          , Xu          , Xu          , Xu          , Xu          , Xu          , Xu          , Xu          , Xu          , Xu          , Xu          , Xu          , Xu          , Xu          , Xu          , Xu          , Xu          , Xu          
Xu          , Xu          , Xu          , Xu          , Xu          , Xu          , Xu          , Xu          , Xu          , Xu          , Xu          , Xu          , Xu          , Xu          , Xu          , Xu          , Uu          , Uu          , Xu          , Xu          , Xu          , Xu          , Xu          , Xu          , Xu          , Xu          , Xu          , Xu          , Xu          , Xu          , Xu          , Xu          , Xu          , Xu          , Xu          , Xu          , Xu          
