border_size=1
usage=map

Xu          , Xu          , Xu          , Xu          , Xu          , Xu          , Xu          , Xu          , Xu          , Xu          , Xu          , Xu          , Xu          , Xu          , Xu          , Xu          , Xu          , Xu          , Xu          , Xu          , Xu          , Xu          
Xu          , Xu          , Xu          , Xu          , Xu          , Xu          , Xu          , Xu          , Xu          , Xu          , Uh          , Xu          , Uu^Ufi      , Xu          , Xu          , Xu          , Xu          , Xu          , Xu          , Xu          , Xu          , Xu          
Xu          , Xu          , Uh          , 3 Uh        , Uu          , Uu          , Uu          , Uu          , Uu          , Uu          , Uu          , Uu          , Uu^Ii       , Uu          , Uu          , Uu^Uf       , Uu          , Xu          , Xu          , Xu          , Xu          , Xu          
Xu          , Xu          , Uu          , Uu          , Xu          , Rp          , Uu          , Uu          , Uu          , Uu^Ii       , Rr          , Rr          , Rr          , Rr          , Rr          , Uu          , Uu          , Uu          , Uu          , Xu          , Xu          , Xu          
Xu          , Xu          , Uu          , Xu          , Xu          , Rp          , Uu          , Uu^Ii       , Rr          , Rr          , Rr          , Rr          , Rr          , Rr          , Rr          , Uu^Ii       , Uu          , Xu          , Uu          , Uu^Uf       , Xu          , Xu          
Xu          , Xu          , Uu          , Uu          , Re          , Rp          , Xu          , Uu          , Rr          , Rr          , Rr          , Rr          , Rr          , Rr          , Rr          , Rr          , Uu^Ii       , Xu          , Re          , Uu          , Xu          , Xu          
Xu          , Xu          , Uu          , Uu          , Re          , Rp          , Xu          , Uu          , Uu^Ii       , Rr          , Rr          , Rr          , Rr          , Rr          , Uu          , Rr          , Uu          , Uu          , Rp          , Uu          , Xu          , Xu          
Xu          , Xu          , Uu          , Xu          , Xu          , Rp          , Uu^Uf       , Xu          , Xu          , Uu          , Uu          , Uu^Ii       , Uu          , Uu^Ii       , Xu          , Uu          , Xu          , Uu          , Rp          , Uu          , Xu          , Xu          
Xu          , Xu          , Uu          , Xu          , Xu          , Rp          , Uu          , Xu          , Uu^Vu       , Xu          , Xu          , Xu          , Rp          , Uu          , Xu          , Xu          , Xu          , Re          , Rp          , Uu          , Xu          , Xu          
Xu          , Xu          , Uu          , Uu          , Rp          , Rp          , Xu          , Xu          , Uu          , Xu          , Uu          , Xu          , Rp          , Xu          , Uu^Vu       , Xu          , Xu          , Rp          , Uh          , Uh          , Xu          , Xu          
Xu          , Xu          , Uu^Uf       , Uu          , Rp          , Rp          , Xu          , Xu          , Uu          , Uu          , Uu          , Rp          , Xu          , Uu          , Uu          , Xu          , Xu          , Rp          , Uh          , Uu          , Xu          , Xu          
Xu          , Xu          , Uu          , Uu          , Rp          , Xu          , Xu          , Xu          , Xu          , Rp          , Xu          , Xu          , Xu          , Xu          , Re          , Xu          , Xu          , Uu          , Uu          , Uu          , Xu          , Xu          
Xu          , Xu          , Uu          , Uu          , Rp          , Xu          , Xu          , Xu          , Xu          , Rp          , Xu          , Xu          , Rp          , Rp          , Xu          , Xu          , Xu          , Uu          , Uu          , Uu          , Xu          , Xu          
Xu          , Xu          , Uu          , Uu          , Uu          , Rp          , Xu          , Xu          , Uu          , Rp          , Xu          , Re          , Uu          , Xu          , Xu          , Xu          , Uu          , Uu          , Uu          , Uu          , Xu          , Xu          
Xu          , Uu          , Re          , Uu          , Uh          , Uu          , Uu          , Xu          , 1 Uu        , Xu          , Xu          , Xu          , Uu          , Uu          , Uu          , Uu          , Re          , Re          , Uu          , Uh          , Xu          , Xu          
Xu          , Uu          , Uu          , Xu          , Xu          , Uh          , Uu          , Rp          , Rp          , Xu          , Uu          , Rp          , Rp          , Uu          , Uu          , Uu          , Uu          , Uu          , Uu^Uf       , Xu          , Xu          , Xu          
Xu          , Xu          , Uu          , Uu          , Rp          , Uh          , Uu          , Rp          , Uu          , Uu          , Rp          , Rp          , Xu          , Xu          , Uu          , Uu          , Uu          , Uu          , Xu          , Xu          , Xu          , Xu          
Xu          , Xu          , Xu          , Uu          , Rp          , Uu          , Xu          , Xu          , Uu          , Uh          , Rp          , Xu          , Uu          , Xu          , Uu          , Uu          , Uh          , Xu          , Xu          , Xu          , Xu          , Xu          
Xu          , Xu          , Xu          , Uu          , Uu          , Uu          , Uu          , Xu          , Uu          , Uu          , Rp          , Uu          , Uu          , Uu          , Uu          , Uh          , Xu          , Xu          , Xu          , Xu          , Xu          , Xu          
Xu          , Xu          , Xu          , Uh          , Uh          , Uu          , Uu          , Uu          , Ce          , Ce          , Ce          , Uu          , Xu          , Uu^Uf       , Xu          , Xu          , Xu          , Xu          , Xu          , Xu          , Xu          , Xu          
Xu          , Xu          , Xu          , Xu          , Xu          , Xu          , Xu          , Uu^Uf       , Xu          , 2 Ke        , Rp          , Xu          , Xu          , Xu          , Xu          , Xu          , Xu          , Xu          , Xu          , Xu          , Xu          , Xu          
Xu          , Xu          , Xu          , Xu          , Xu          , Xu          , Xu          , Xu          , Xu          , Uu          , Uu          , Xu          , Xu          , Xu          , Xu          , Xu          , Xu          , Xu          , Xu          , Xu          , Xu          , Xu          
