border_size=1
usage=map

Gs          , Gs          , Gs          , Gs          , Gs          , Gs          , Gs          , Gs          , Gs          , Gs          , Gs          , Gs          , Gs          , Gs          , Gs          , Gs          , Gs          , Gs          , Gs          , Gs          , Gs          , Gs          
Gs          , Gs          , Gs          , Gs          , Gs          , Gs          , Gs          , Gs          , Gs          , Gs          , Gs          , Gs          , Gs          , Gs          , Gs          , Gs          , Gs          , Gs          , Gs          , Gs          , Gs          , Gs          
Gs          , Gs          , Gs          , Gs          , Rr          , Rr          , Rr          , Rr          , Rr          , Gs          , Rr          , Rr          , Rr          , Gs          , Rr          , Gs          , Gs          , Gs          , Gs          , Gs          , Rr          , Gs          
Rr          , Rr          , Rr          , Rr          , Rr          , Rr          , Rr          , Rr          , Rr          , Rr          , Rr          , Rr          , Rr          , Rr          , Rr          , Gs          , Gs          , Gs          , Gs          , Rr          , Rr          , Rr          
Rr          , Rr          , Rr          , Rr          , Rr          , Rr          , Rr          , Rr          , Rr          , Rr          , Rr          , Rr          , Rr          , Rr          , Rr          , Gs          , Gs          , Gs          , Gs          , Rr          , Rr          , Rr          
Rr          , Rr          , Rr          , Rr          , Rr          , Rr          , Rr          , Rr          , Rr          , Rr          , Rr          , Rr          , Aa          , Rr          , Aa          , Rr          , Gs          , Gs          , Gs          , Rr          , Rr          , Rr          
Rr          , Rr          , Rr          , Rr          , Rr          , Rr          , Ch          , Rr          , Ch          , Ch          , Ch          , Rr          , Aa          , Aa          , Aa          , Aa          , Gs          , Gs          , Gs          , Rr          , Rr          , Rr          
Rr          , Rr          , Rr          , Rr          , Ch          , Ch          , Rr          , Ch          , Rr          , Rr          , Rr          , Ch          , Ch          , Ch          , Ch          , Aa          , Aa          , Gs          , Rr          , Rr          , Rr          , Rr          
Aa          , Aa          , Rr          , Ch          , Rr          , Rr          , Rr          , Rr          , Rr          , Ch          , Rr          , Rr          , Rr          , Rr          , Rr          , Ch          , Aa          , Aa          , Rr          , Rr          , Rr          , Rr          
Aa          , Rr          , Rr          , Ch          , Rr          , Rr          , Rr          , Rr          , Ch          , 3 Kh        , Ch          , Rr          , Rr          , Rr          , Rr          , Ch          , Aa          , Aa          , Rr          , Rr          , Rr          , Rr          
Aa          , Rr          , Rr          , Ch          , Rr          , Rr          , Rr          , Rr          , Rr          , Rr          , Rr          , Rr          , Rr          , Rr          , Rr          , Ch          , Aa          , Aa          , Rr          , Rr          , Rr          , Rr          
Rr          , Rr          , Rr          , Ch          , Rr          , 4 Ch        , Rr          , Rr          , Rr          , Rr          , Rr          , Rr          , Rr          , Ch          , Rr          , Ch          , Aa          , Aa          , Rr          , Rr          , Rr          , Rr          
Rr          , Rr          , Rr          , Ch          , Rr          , Rr          , Rr          , Rr          , 1 Rr        , Rr          , 2 Rr        , Rr          , Rr          , Rr          , Rr          , Ch          , Aa          , Aa          , Rr          , Rr          , Rr          , Rr          
Rr          , Rr          , Rr          , Ch          , Ch          , Rr          , Rr          , Rr          , Rr          , Rr          , Rr          , Rr          , Rr          , Rr          , Ch          , Ch          , Rr          , Rr          , Rr          , Rr          , Rr          , Rr          
Ai          , Rr          , Rr          , Rr          , Ch          , Ch          , Ch          , Rr          , Rr          , Rr          , Rr          , Rr          , Ch          , Ch          , Ch          , Rr          , Rr          , Rr          , Rr          , Rr          , Rr          , Rr          
Ai          , Ai          , Rr          , Rr          , Rr          , Ch          , Rr          , Rr          , Rr          , Rr          , Rr          , Rr          , Rr          , Ch          , Rr          , Rr          , Rr          , Rr          , Rr          , Rr          , Rr          , Rr          
Ai          , Ai          , Ai          , Rr          , Rr          , Rr          , Rr          , Rr          , Rr          , Rr          , Rr          , Rr          , Rr          , Rr          , Rr          , Rr          , Rr          , Rr          , Rr          , Rr          , Rr          , Rr          
Gs          , Ai          , Ai          , Ai          , Rr          , Rr          , Rr          , Rr          , Rr          , Rr          , Rr          , Rr          , Rr          , Rr          , Rr          , Rr          , Rr          , Rr          , Rr          , Rr          , Rr          , Rr          
Gs          , Gs          , Gs          , Ai          , Gs          , Rr          , Rr          , Rr          , Rr          , Rr          , Rr          , Rr          , Rr          , Rr          , Rr          , Rr          , Rr          , Rr          , Rr          , Rr          , Rr          , Rr          
Gs          , Gs          , Gs          , Gs          , Gs          , Gs          , Rr          , Rr          , Rr          , Rr          , Rr          , Rr          , Rr          , Rr          , Rr          , Rr          , Rr          , Rr          , Rr          , Rr          , Rr          , Rr          
Gs          , Gs          , Gs          , Gs          , Gs          , Gs          , Gs          , Rr          , Rr          , Rr          , Rr          , Rr          , Rr          , Rr          , Rr          , Rr          , Rr          , Rr          , Rr          , Rr          , Rr          , Rr          
Gs          , Gs          , Gs          , Gs          , Gs          , Gs          , Gs          , Rr          , Rr          , Rr          , Rr          , Rr          , Rr          , Rr          , Rr          , Rr          , Rr          , Rr          , Rr          , Rr          , Rr          , Rr          
