border_size=1
usage=map

Aa^Fpa      , Aa^Fpa      , Aa^Fpa      , Aa^Fpa      , Ha          , Ms          , Ms          , Ms          , Ms          , Ms          , Ha          , Aa          , Aa          , Aa          , Ai          , Ai          , Ai          , Ce          , Ce          , Aa          , Aa          , Aa          
Aa^Fpa      , Aa^Fpa      , Aa^Fpa      , Aa^Fpa      , Aa^Fpa      , Aa          , Ha          , Ha          , Ha          , Ha          , Uh          , Aa          , Aa          , Aa          , Re^Gvs      , Ai          , Re^Gvs      , Re^Gvs      , Ce          , Ce          , Ce          , Aa          
Aa^Fpa      , Aa^Fpa      , Aa^Fpa      , Gs^Fp       , Gs^Fp       , Uh          , Uh          , Uh          , Uh          , Uh          , Uh          , Uh          , Re          , Gg^Vh       , Re^Gvs      , Ww          , Re^Gvs      , Re^Gvs      , Ce          , 2 Ke        , Ce          , Aa          
Aa          , Aa          , Aa^Fpa      , Gs^Fp       , 4 Ke        , Uh          , Uh          , Uu          , Qxu         , Uu          , Uu          , Uu          , Uu          , Re^Gvs      , Ww          , Ww          , Re^Gvs      , Re^Gvs      , Re^Gvs      , Ce          , Re^Gvs      , Ce          
Ha          , Aa          , Aa^Fpa      , Uu          , Uu          , Ce          , Uu          , Uu          , Qxu         , Qxu         , Uu          , Uu          , Ww          , Ww          , Gg^Vh       , Re^Gvs      , Re^Gvs      , Re^Gvs      , Re^Gvs      , Re^Gvs      , Aa          , Ce          
Ha          , Aa          , Aa          , Aa          , Uu          , Uu          , Uu          , Uu^Vu       , Uu          , Uu          , Ww          , Ww          , Uu          , Rp          , Re          , Re^Gvs      , Re^Gvs      , Re^Gvs      , Re^Gvs      , Re^Gvs      , Aa          , Ce          
Aa          , Aa          , Ai          , Aa^Fpa      , Rp          , Uu          , Ql          , Uu          , Uu          , Uu          , Ww^Bw\      , Uu          , Rp          , Rp          , Gs^Fp       , Re          , Re          , Re^Gvs      , Re^Gvs      , Re^Gvs      , Aa          , Ce          
Ce          , Aa          , Ai          , Ai          , Rp          , Uu          , Uu          , Uu          , Ww          , Ww          , Uu          , Uu          , Rp          , Rp          , Re          , Re          , Re          , Re          , Re          , Aa          , Ce          , Ce          
Ce          , Gg          , Rp          , Ai          , Ai          , Gs^Fp       , Rp          , Ww          , Uu          , Uu          , Uu          , Rp          , Rp          , Re^Gvs      , Re^Gvs      , Re^Gvs      , Gg^Wm       , Re^Gvs      , Re^Gvs      , Rp          , Ce          , Aa          
Ce          , Gg          , Rp          , Rp          , Ai          , Ai          , Ai          , Ww          , Uu          , Ql          , Uu          , Rp          , Gs          , Re^Gvs      , Re^Gvs      , Re^Gvs      , Re^Gvs      , Re^Gvs      , Rp          , Ce          , Gg          , Aa          
Ce          , Gg          , 3 Ke        , Ce          , Rp          , Ai          , Rp          , Ww          , Uu          , Uu          , Rp          , Gg^Vh       , Re          , Re^Gvs      , Gg^Fet      , Re          , Rp          , Rp          , Ce          , Ce          , Gg          , Aa          
Ce          , Gg          , Ggf         , Gg^Fet      , Gg^Vh       , Rp          , Ww          , Ww^Bw\      , Rr          , Rp          , Rp          , Re          , Re          , Re          , Gg^Vh       , Rp          , Rp          , Ce          , Gg          , Gg          , Aa          , Aa          
Ce          , Gg          , Ww          , Ggf         , Ww          , Ww          , Rp          , Rr          , Rr          , Rr          , Rp          , Gg^Vh       , Gs          , Gs          , Rp          , Rp          , Ce          , Ce          , Gg          , Aa          , Aa^Fpa      , Gs^Fp       
Ce          , Ggf         , Ww          , Ww          , Ww          , Ggf         , Rp          , Rp          , Rr          , Ai          , Rr          , Rp          , Rp          , Rp          , Rp          , Ce          , Ce          , Gg          , Gg          , Gg          , Gs^Fp       , Gs^Fp       
Ce          , Aa          , Ai          , Ww          , Ww          , Ggf         , Rp          , Rp          , Rr          , Rr          , Gg^Vh       , Rr          , Rr          , Gs^Fp       , Rr          , Rr          , Rr          , Gg          , Gg          , Gg          , Gs^Fp       , Gs^Fp       
Ce          , Aa          , Aa          , Ai          , Ggf         , Ggf         , Rp          , Rp          , Rp          , Rp          , Rp          , Rp          , Rr          , Rr          , Ce          , Rr          , Rr          , Gg          , Gg          , Gg          , Gs^Fp       , Gs^Fp       
Ce          , Aa          , Rp          , Ggf         , Rp          , Rp          , Rp          , Rp          , Rp          , Gs^Fp       , Rp          , Rp          , Rp          , Rr          , Rr          , Rr          , Rr          , Re          , Re          , Gg          , Gg          , Gg          
Ce          , Aa          , Re^Gvs      , Rp          , Re^Gvs      , Re^Gvs      , Re^Gvs      , Gg^Vh       , Gs^Fp       , Rp          , Rp          , Rp          , Ce          , Ce          , Gg          , Rr          , Re          , Rr          , Re          , Re          , Re          , Gg          
Ce          , Aa          , Re^Gvs      , Re^Gvs      , Re^Gvs      , Re^Gvs      , Re^Gvs      , Re          , Rp          , Rp          , Ce          , Ce          , Gg          , Gg          , Gg          , Gg          , Gg          , Re          , Re          , Re          , Re          , Re          
Aa          , Aa          , Re^Gvs      , Re^Gvs      , Re^Gvs      , Re^Gvs      , Re          , Re          , Rp          , Rp          , 1 Ke        , Ce          , Gg          , Aa          , Aa          , Aa          , Aa          , Gg          , Gg          , Re          , Re          , Re          
Aa          , Re^Gvs      , Re^Gvs      , Re^Gvs      , Re^Gvs      , Re^Gvs      , Re^Gvs      , Rp          , Aa          , Ce          , Gg          , Gg          , Gg          , Gg          , Aa^Fpa      , Aa^Fpa      , Aa^Fpa      , Aa          , Aa          , Gg          , Gg          , Re          
Aa          , Ha          , Ha          , Ha          , Aa          , Aa          , Aa          , Aa          , Ce          , Ce          , Aa          , Aa          , Aa          , Aa          , Aa          , Ha          , Ha          , Aa          , Aa          , Gg          , Gg          , Gg          
