border_size=1
usage=map

Xu          , Xu          , Xu          , Xu          , Xu          , Xu          , Xu          , Xu          , Xu          , Xu          , Xu          , Xu          , Xu          , Xu          , Xu          , Xu          , Xu          , Xu          , Xu          , Xu          , Xu          , Xu          , Xu          , Xu          , Qxu         , Qxu         , Qxu         , Qxu         , Qxu         , Qxu         , Qxu         , Xu          , Xu          , Xu          , Xu          , Xu          , Rr          , Rr          , Rr          , Rr          , Rr          , Rr          
Uu          , Xu          , Uu^Uf       , Xu          , Ce          , Xu          , Uu          , Xu          , Uu^Uf       , Xu          , Xu          , Xu          , Xu          , Xu          , Uu          , Xu          , Uu          , Xu          , Uu^Vu       , Xu          , Uu^Vu       , Xu          , Xu          , Qxu         , Qxu         , Qxu         , Qxu         , Qxu         , Qxu         , Qxu         , Qxu         , Xu          , Xu          , Xu          , Xu          , Xu          , Rr          , Rr          , Rr          , Rr          , Rr          , Rr          
Uu          , Uu          , Rr          , Uu          , 1 Ke        , Ce          , Uu          , Uu          , Rr          , Uu          , Uu          , Uu          , Rr          , Uu          , Uu          , Uu          , Uu          , Uu          , Uu          , Uu          , Uu          , Xu          , Uu          , Qxu         , Uu          , Uh          , Uu          , Uh          , Uu          , Qxu         , Uu          , Uu          , Xu          , Xu          , Rr          , Rr          , Rr          , Cud         , Rr          , Rr          , Rr          , Rr          
Uu          , Uu          , Uu          , Rr          , Ce          , Ce          , Rr          , Rr          , Rr          , Uu          , Rr          , Rr          , Uu          , Rr          , Rr          , Rr          , Uu          , Uu          , Uu          , Uu          , Xu          , Xu          , Uu          , Uh          , Uu          , Uu          , Qxu         , Uu          , Uu          , Uu^Vu       , Uu          , Uh          , Xu          , Xu          , Uu          , Rr          , Rr          , Rr          , Rr          , Cud         , Rr          , Rr          
Uu          , Uu          , Uu          , Uu          , Ce          , Ce          , Uu          , Uu          , Xu          , Uu          , Xu          , Uu          , Xu          , Xu          , Xu          , Rr          , Rr          , Uu          , Uu          , Uu          , Xu          , Uu          , Uu          , Uh          , Uu^Vu       , Uu          , Uu          , Qxu         , Uu          , Uu          , Uh          , Qxu         , Xu          , Uu^Vud      , Uu          , Uu          , Rr          , Rr          , Rr          , Rr          , Cud         , Rr          
Xu          , Xu          , Xu          , Xu          , Xu          , Xu          , Xu          , Xu          , Uu^Vu       , Xu          , Uu          , Xu          , Uu^Vu       , Xu          , Uu          , Uu          , Rr          , Uu          , Xu          , Xu          , Uu^Vu       , Uu          , Uu          , Uu          , Uu          , Uu          , Qxu         , Uu          , Uu          , Uu          , Uu          , Uh          , Xu          , Uu          , Uu          , Uu          , Uu          , Rr          , Rr          , Rr          , Rr          , Rr          
Xu          , Xu          , 2 Khr       , Xu          , Chr         , Uu          , Uu          , Uu          , Uu          , Uu          , Uu          , Uu          , Uu          , Uu          , Rr          , Rr          , Xu          , Xu          , Xu          , Xu          , Uu          , Uu          , Uh          , Uh          , Uu          , Uu          , Uu          , Uu          , Uu          , Uu          , Uu          , Xu          , Xu          , Uu          , Uu          , Uu          , Uu          , Uu          , Uu          , Rr          , Rr          , Rr          
Xu          , Xu          , Chr         , Chr         , Uu          , Uu          , Uu          , Uu          , Uu          , Uu          , Uu          , Uu          , Rr          , Rr          , Uu          , Xu          , Xu          , Xu          , Uu          , Uu          , Uu          , Uh          , Uh          , Uu          , Uu          , Qxu         , Qxu         , Uu          , Uu          , Uu          , Xu          , Xu          , Uu          , Uu          , Uu          , Uu          , 3 Khr       , Uu          , Uu          , Uu^Vud      , Xu          , Xu          
Xu          , Xu          , Uu          , Uu          , Uu^Vu       , Uu          , Uu          , Uu          , Uu          , Rr          , Rr          , Rr          , Uu          , Uu          , Xu          , Xu          , Uu          , Uu          , Uu          , Uu          , Uu          , Uu          , Uu          , Uu          , Qxu         , Qxu         , Uu          , Uu          , Uu          , Uu          , Xu          , Xu          , Uu          , Uu          , Chr         , Chr         , Chr         , Chr         , Chr         , Uu          , Xu          , Xu          
Xu          , Xu          , Uu          , Uu          , Uh          , Uh          , Uu          , Uu          , Rr          , Uu          , Uu          , Uu          , Xu          , Xu          , Xu          , Uu          , Uu          , Uu          , Qxu         , Uu          , Uu          , Uu          , Qxu         , Qxu         , Uu          , Uu          , Uu          , Uu          , Uu^Vu       , Xu          , Xu          , Uu^Vu       , Uu          , Uu          , Rr          , Rr          , Chr         , Uu          , Uu          , Uu          , Xu          , Xu          
Xu          , Xu          , Uu          , Uu          , Uu          , Uu          , Rr          , Uu          , Uu          , Uu          , Xu          , Xu          , Uu^Vu       , Xu          , Uu          , Uu          , Uu          , Uu          , Qxu         , Qxu         , Qxu         , Qxu         , Qxu         , Uh          , Uu          , Uu          , Uu          , Uu          , Xu          , Xu          , Uu          , Uu          , Uu          , Uu          , Rr          , Uu          , Uu          , Uu          , Uu          , Uu          , Xu          , Xu          
Xu          , Xu          , Uu          , Uu          , Uu          , Rr          , Rr          , Uu          , Xu          , Xu          , Uu          , Uu          , Uu          , Uu          , Uu          , Uu          , Uu          , Uu          , Qxu         , Qxu         , Qxu         , Qxu         , Uu          , Uu          , Uu          , Uu          , Uu          , Xu          , Uu          , Uu          , Uu          , Uu          , Uu          , Uu          , Rr          , Uu          , Uu          , Uu          , Uu          , Uu          , Xu          , Xu          
Xu          , Xu          , Uu          , Uu          , Uu          , Rr          , Uu          , Uu^Vu       , Xu          , Uu^Vu       , Uu          , Uu          , Uu          , Uu          , Qxu         , Qxu         , Qxu         , Uh          , Qxu         , Qxu         , Qxu         , Qxu         , Uu          , Uu          , Uh          , Uu          , Xu          , Xu          , Uu          , Uu          , Uu          , Uu          , Uu          , Uu          , Rr          , Uu          , Uu          , Xu          , Uu          , Uu          , Xu          , Xu          
Xu          , Xu          , Uu^Vu       , Uu          , Uu          , Rr          , Uh          , Xu          , Uu          , Uu          , Uu          , Uu          , Uu          , Qxu         , Qxu         , Qxu         , Qxu         , Qxu         , Qxu         , Qxu         , Uu          , Uu          , Uu          , Uh          , Uh          , Uu          , Xu          , Uu^Vu       , Uu          , Uu          , Uu          , Uu          , Rr          , Uu          , Uu          , Uu          , Uu          , Uu          , Uu          , Uu          , Xu          , Xu          
Xu          , Xu          , Xu          , Uu          , Uh          , Uh          , Uh          , Uu          , Uu          , Uu          , Uu          , Uu          , Uu          , Qxu         , Qxu         , Qxu         , Qxu         , Qxu         , Uu          , Uu          , Uu          , Uu          , Uu          , Uu          , Xu          , Xu          , Uu          , Uu          , Uu          , Uu          , Rr          , Rr          , Uu          , Uu          , Uu          , Uu          , Xu          , Xu          , Uu          , Uu          , Xu          , Xu          
Xu          , Xu          , Uh          , Xu          , Uu          , Uu          , Uu          , Rr          , Rr          , Rr          , Rr          , Uu          , Qxu         , Qxu         , Uu          , Uu          , Uu          , Uu          , Uu          , Uu          , Uu          , Uu          , Uu^Vu       , Xu          , Uu          , Uu          , Uu          , Uu          , Uu          , Uu          , Rr          , Rr          , Uu          , Uu          , Uu          , Uu          , Xu          , Xu          , Uu          , Uu          , Xu          , Xu          
Ql          , Xu          , Ql          , Uu          , Uu          , Uu          , Uu          , Uu          , Uu          , Rr          , Qxu         , Qxu         , Qxu         , Rr          , Rr          , Rr          , Rr          , Rr          , Rr          , Uu          , Rr          , Uu          , Xu          , Xu          , Uu          , Uu          , Rr          , Uu^Vu       , Uu          , Rr          , Uu          , Uu          , Uu          , Uu          , Xu          , Xu          , Uu^Vud      , Uu^Vud      , Uu          , Uu          , Xu          , Xu          
Ql          , Ql          , Ql          , Ql          , Ql          , Ql          , Ql          , Ql          , Ql          , Qxu         , Qxu         , Qxu         , Uh          , Uu          , Uu          , Uu          , Uu          , Uu          , Uu          , Rr          , Uu          , Rr          , Rr          , Rr          , Rr          , Rr          , Uu          , Rr          , Uu          , Uu          , Uu          , Uu          , Uu          , Xu          , Uu          , Xu          , Xu          , Uu          , Xu          , Xu          , Xu          , Xu          
Ql          , Ql          , Ql          , Ql          , Ql          , Ql          , Ql          , Ql          , Ql          , Ql          , Qxu         , Qxu         , Ql          , Uu          , Ql          , Uu          , Ql          , Uh          , Ql          , Uu          , Uu          , Uu          , Uu          , Uu          , Uh          , Uu          , Uu          , Uu          , Uu          , Uu          , Uu          , Uu          , Uu          , Uu          , Uu          , Uu          , Xu          , Xu          , Xu          , Xu          , Xu          , Xu          
Ql          , Ql          , Ql          , Ql          , Ql          , Ql          , Ql          , Ql          , Ql          , Ql          , Ql          , Ql          , Ql          , Ql          , Ql          , Ql          , Ql          , Ql          , Ql          , Ql          , Ql          , Ql          , Ql          , Uh          , Ql          , Uh          , Ql          , Uu          , Ql          , Uu          , Uu          , Uu          , Uu          , Uu          , Ql          , Xu          , Ql          , Ql          , Ql          , Ql          , Ql          , Ql          
Ql          , Ql          , Ql          , Ql          , Ql          , Ql          , Ql          , Ql          , Ql          , Ql          , Ql          , Ql          , Ql          , Ql          , Ql          , Ql          , Ql          , Ql          , Ql          , Ql          , Ql          , Ql          , Ql          , Ql          , Ql          , Ql          , Ql          , Ql          , Ql          , Ql          , Ql          , Ql          , Ql          , Ql          , Ql          , Ql          , Ql          , Ql          , Ql          , Ql          , Ql          , Ql          
Ql          , Ql          , Ql          , Ql          , Ql          , Ql          , Ql          , Ql          , Ql          , Ql          , Ql          , Ql          , Ql          , Ql          , Ql          , Ql          , Ql          , Ql          , Ql          , Ql          , Ql          , Ql          , Ql          , Ql          , Ql          , Ql          , Ql          , Ql          , Ql          , Ql          , Ql          , Ql          , Ql          , Ql          , Ql          , Ql          , Ql          , Ql          , Ql          , Ql          , Ql          , Ql          
