border_size=1
usage=map

Aa^Fpa      , Aa^Fpa      , Aa^Fpa      , Aa^Fpa      , Aa^Fpa      , Aa^Fpa      , Re          , Re          , Re          , Aa^Fpa      , Aa^Fpa      , Aa^Fpa      , Aa^Fpa      , Aa^Fpa      , Aa^Fpa      , Aa^Fpa      , Aa^Fpa      , Aa^Fpa      , Aa^Fpa      , Aa^Fpa      , Aa^Fpa      , Aa^Fpa      , Aa^Fpa      , Aa^Fpa      , Aa^Fpa      , Aa^Fpa      , Ha          , Ha          , Ha          , Ha          , Ha          , Ha          , Ha          , Ha          , Ha          , Ha          , Ha          , Ha          , Ha          , Ha          , Ha          , Ha          
Ha          , Aa^Fpa      , Aa^Fpa      , Aa^Fpa      , Aa^Fpa      , Re          , Re          , Re          , Aa^Fpa      , Aa^Fpa      , Aa^Fpa      , Aa^Fpa      , Aa^Fpa      , Aa          , Aa^Fpa      , Aa          , Aa^Fpa      , Aa          , Aa^Fpa      , Aa          , Aa^Fpa      , Aa          , Aa^Fpa      , Aa^Fpa      , Aa^Fpa      , Aa          , Aa^Fpa      , Ha          , Aa^Fpa      , Ha          , Ha^Vhha     , Ha          , Ha          , Ha          , Ha          , Ha          , Ha          , Ha          , Ha          , Ha          , Ha          , Ha          
Ha          , Ha          , Aa^Fpa      , Aa^Fpa      , Aa^Fpa      , Re          , Re          , Re          , Aa^Fpa      , Aa^Fpa      , Aa^Fpa      , Aa^Fpa      , Aa^Fpa      , Aa^Fpa      , Aa^Fpa      , Aa^Fpa      , Aa^Fpa      , Aa^Fpa      , Aa^Fpa      , Aa^Fpa      , Aa^Fpa      , Aa^Fpa      , Aa^Fpa      , Aa^Fpa      , Aa^Fpa      , Aa^Fpa      , Aa^Fpa      , Aa^Fpa      , Aa^Fpa      , Aa^Fpa      , Aa^Fpa      , Aa^Fpa      , Aa^Fpa      , Aa^Fpa      , Aa^Fpa      , Ha          , Aa^Fpa      , Ha          , Ha          , Ha          , Ha          , Ha          
Ha          , Ha          , Ha          , Aa^Fpa      , Aa^Fpa      , Re          , Re          , Re          , Aa          , Aa          , Aa          , Aa          , Aa          , Aa          , Aa          , Aa          , Aa          , Aa^Fpa      , Aa^Vha      , Aa^Fpa      , Aa          , Aa^Fpa      , Aa          , Aa^Fpa      , Aa          , Aa^Fpa      , Aa          , Aa^Fpa      , Aa^Fpa      , Aa^Fpa      , Aa^Fpa      , Aa^Fpa      , Aa^Fpa      , Aa^Fpa      , Aa^Fpa      , Aa^Fpa      , Aa^Fpa      , Aa^Fpa      , Aa^Fpa      , Ha          , Ha          , Ha          
Ha          , Ha          , Ha          , Aa^Fpa      , Aa^Fpa      , Re          , Re          , Re          , Ce          , Ce          , Ce          , Aa          , Aa          , Aa          , Aa          , Aa          , Aa          , Aa^Fpa      , Aa          , Aa          , Aa          , Aa          , Aa          , Aa          , Aa          , Aa          , Aa^Vha      , Aa          , Aa          , Aa          , Aa          , Aa          , Aa          , Aa          , Aa          , Aa^Fpa      , Aa^Fpa      , Aa^Fpa      , Aa^Fpa      , Ha          , Ha          , Ha          
Ha          , Ha          , Ha^Vhha     , Aa^Fpa      , Re          , Aa^Fpa      , Re          , Re          , Ce          , 7 Ke        , Ce          , Aa          , Aa          , Aa          , Aa          , Aa          , Aa          , Aa^Fpa      , Aa^Fpa      , Aa          , Aa          , Aa          , Aa          , Aa          , Aa          , Aa          , Aa          , Aa          , Aa          , Aa          , Re          , Aa          , Re          , Aa          , Aa          , Aa          , Aa          , Aa^Fpa      , Aa^Fpa      , Ha^Vhha     , Ha          , Ha          
Ha          , Ha          , Aa^Fpa      , Aa^Fpa      , Re          , Re          , Re          , Re          , Aa          , Ce          , Aa          , Aa          , Aa          , Aa          , Aa          , Aa          , Aa          , Aa^Fpa      , Aa^Fpa      , Aa^Fpa      , Aa^Fpa      , Aa          , Aa          , Aa          , Aa          , Aa          , Aa          , Aa          , Aa          , Re          , Re          , Re          , Re          , Aa          , Aa          , Aa          , Aa          , Aa          , Aa^Fpa      , Aa^Fpa      , Aa^Fpa      , Ha          
Ha          , Ha          , Aa^Fpa      , Re          , Re          , Chr         , Chr         , Re          , Re          , Aa          , Aa          , Aa          , Aa          , Aa          , Aa          , Aa          , Aa          , Aa          , Aa^Vha      , Aa^Fpa      , Aa          , Aa^Fpa      , Aa^Fpa      , Aa          , Aa          , Aa          , Aa          , Aa          , Aa          , Re          , Chr         , Chr         , Re          , Re          , Aa          , Aa          , Aa^Vha      , Aa          , Aa          , Aa^Fpa      , Aa^Fpa      , Ha          
Aa^Fpa      , Aa^Fpa      , Aa          , Aa          , Aa          , Re          , Re          , Chr         , Re          , Re          , Re          , Aa          , Aa          , Aa          , Aa          , Aa          , Aa          , Aa          , Aa          , Aa          , Aa          , Aa          , Aa^Fpa      , Aa^Fpa      , Aa^Vha      , Aa          , Aa          , Aa          , Aa          , Ch          , Aa          , Re          , Re          , Aa          , Aa          , Aa          , Aa          , Aa          , Aa          , Aa          , Aa^Fpa      , Aa^Fpa      
Aa^Fpa      , Aa^Fpa      , Aa          , Aa          , Aa          , Aa          , Aa          , Ch          , Ch          , Re          , Re          , Re          , Aa          , Aa          , Aa          , Aa          , Aa          , Aa          , Aa          , Aa          , Aa          , Aa^Fpa      , Aa^Fpa      , Aa^Fpa      , Aa          , Aa          , Aa          , Aa          , Ch          , Ch          , Aa          , Aa          , Aa          , Aa          , Aa          , Aa          , Ce          , Aa          , Aa          , Aa          , Aa^Fpa      , Aa^Fpa      
Aa^Fpa      , Aa^Fpa      , Aa          , Aa          , Aa          , Aa          , Aa          , Aa          , Aa          , Ch          , Ch          , Re          , Re          , Aa          , Aa          , Aa          , Aa          , Aa          , Aa          , Aa          , Aa          , Aa          , Aa          , Aa          , Aa          , Aa          , Aa          , Aa          , Ch          , Aa          , Aa          , Aa          , Aa          , Aa          , Aa          , Ce          , 2 Ke        , Ce          , Aa          , Aa          , Aa^Fpa      , Aa^Fpa      
Aa^Fpa      , Aa^Fpa      , Aa^Fpa      , Aa          , Aa^Vha      , Aa          , Aa          , Aa          , Aa          , Aa          , Ch          , Re          , Re          , Re          , Re          , Aa          , Ch          , Aa          , Ch          , Ch          , Ch          , Aa          , Aa          , Aa          , Aa          , Aa          , Ch          , Ch          , Aa          , Aa          , Aa          , Aa          , Aa          , Aa          , Aa          , Ce          , Ce          , Ce          , Aa          , Aa          , Aa^Fpa      , Aa^Fpa      
Ha          , Aa^Fpa      , Aa          , Aa^Fpa      , Aa          , Aa          , Aa          , Aa          , Aa          , Aa          , Ch          , Ch          , Re          , Re          , Gg          , Ch          , Gg          , Ch          , Gg          , Gg^Ve       , Gg          , Ch          , Ch          , Ch          , Ch          , Ch          , Ch          , Aa          , Ch          , Aa          , Aa          , Aa          , Aa          , Aa          , Aa          , Aa          , Aa          , Aa          , Aa          , Aa          , Aa^Fpa      , Aa^Fpa      
Ha          , Ha          , Aa          , Aa          , Aa          , Aa          , Aa          , Aa          , Ch          , Ch          , Rp          , Rp          , Rp          , Gg          , Gg          , Gg          , Gg          , Gg          , Gg^Ve       , Gg          , Gg          , Gg          , Gg          , Gg          , Gg          , Gg          , Gg          , Ch          , Gg          , Ch          , Ch          , Aa          , Aa          , Aa          , Aa          , Aa          , Aa          , Aa          , Aa          , Aa          , Aa^Fpa      , Aa^Fpa      
Ha          , Ha          , Aa          , Aa          , Aa          , Aa          , Ch          , Ch          , Gg          , Gg          , Gg^Ve       , Rp          , Rp          , Rp          , Ch          , Ch          , Ch          , Ch          , Ch          , Ch          , Ch          , Gg          , Ch          , Gg          , Gg          , Ggf         , Gg          , Gg          , Gg          , Gg          , Gg          , Ch          , Ch          , Aa          , Aa          , Aa          , Aa          , Aa          , Aa^Vha      , Aa^Fpa      , Aa^Fpa      , Aa^Fpa      
Ha          , Ha          , Aa          , Aa          , Ch          , Ch          , Gg          , Gg          , Gg          , Ch          , Ch          , Ch          , Rp          , Rr          , Rr          , Rp          , Rp          , Rp          , Rp          , Rp          , Rp          , Ch          , Rp          , Ch          , Ch          , Gg          , Ch          , Gg^Ve       , Gg          , Gg          , Gg          , Gg^Ve       , Ch          , Aa          , Aa          , Aa          , Aa          , Aa          , Aa          , Aa^Fpa      , Aa^Fpa      , Aa^Fpa      
Ha          , Ha          , Aa          , Aa          , Ch          , Ch          , Gg          , Gg          , Ch          , Ch          , Rp          , Rp          , Ch          , Rr          , Rr          , Rp          , Rr          , Rp          , Rp          , Rp          , Gg^Ve       , Rp          , Rp          , Rp          , Rp          , Ch          , Ch          , Ch          , Ch          , Gg          , Gg          , Gg          , Gg          , Ch          , Ch          , Aa          , Aa          , Aa          , Aa          , Aa          , Aa^Fpa      , Aa^Fpa      
Ha          , Ha          , Aa          , Aa          , Ch          , Gg          , Gg          , Gg          , Gg^Fet      , Ch          , Rp          , Rp          , Ch          , Ch          , Ch          , Rr          , Rr          , Rr          , Rp          , Rp          , Gg^Ve       , Gg^Ve       , Rp          , Rp          , Rp          , Rp          , Rp          , Ch          , Gg          , Gg          , Gg          , Ggf         , Gg          , Gg          , Ch          , Aa          , Aa          , Aa          , Aa          , Aa          , Aa^Fpa      , Aa^Fpa      
Ha          , Ha          , Aa          , Aa          , Ch          , Gg          , Gg          , Ggf         , Gg          , Ch          , Rp          , Rp          , Ch          , 4 Kh        , Ch          , Rp          , Rp          , Rr          , Rr          , Rp          , Rp          , Rp          , Rp          , Rp          , Rp          , Rp          , Rp          , Rp          , Rp          , Gg          , Gg^Ve       , Gg          , Gg          , Gg          , Gg^Ve       , Ch          , Aa          , Aa          , Aa          , Aa          , Aa^Fpa      , Aa^Fpa      
Ha          , Ha          , Aa          , Aa          , Aa          , Ch          , Gg          , Ggf         , Gg          , Ch          , Rp          , Rp          , Rp          , Ch          , Rp          , Rp          , Rp          , Rp          , Rr          , Rp          , Ch          , Rp          , Rp          , Rp          , Ch          , Rp          , Rp          , Rp          , Rp          , Ch          , Ch          , Gg          , Gg          , Gg          , Gg          , Ch          , Aa          , Aa          , Aa          , Aa          , Aa^Fpa      , Aa^Fpa      
Ha          , Ha^Vhha     , Aa          , Aa          , Aa          , Ch          , Gg          , Ggf         , Gg          , Ch          , Rp          , Rp          , Rp          , Rp          , Rp          , Rp          , Rp          , Rp          , Rp          , Rr          , Rr          , Ch          , Ch          , Ch          , Rp          , Rp          , Rp          , Rp          , Rp          , Rp          , Rp          , Ch          , Ch          , Gg          , Gg          , Ch          , Ch          , Aa          , Aa          , Aa          , Aa^Fpa      , Aa^Fpa      
Aa^Fpa      , Aa          , Aa          , Aa          , Aa          , Ch          , Gg          , Gg          , Gg          , Gg^Ve       , Rp          , Rp          , Rp          , Rp          , Rp          , Gg^Ve       , Gg^Ve       , Rp          , Rp          , Rr          , Ch          , Ch          , 3 Kh        , Ch          , Ch          , Rp          , Rr          , Rp          , Rr          , Rp          , Rp          , Rp          , Ch          , Gg          , Gg          , Gg          , Ch          , Aa          , Aa          , Aa          , Aa^Fpa      , Aa^Fpa      
Aa^Fpa      , Aa          , Aa          , Aa          , Aa          , Ch          , Gg          , Gg          , Gg          , Ch          , Rp          , Rp          , Rp          , Rp          , Rp          , Gg^Ve       , Rp          , Rp          , Rr          , Rr          , Rp          , Ch          , Ch          , Ch          , Rp          , Rr          , Rp          , Rr          , Rp          , Rr          , Rr          , Rp          , Rp          , Ch          , Gg          , Gg          , Ch          , Aa          , Aa          , Aa          , Aa^Fpa      , Aa^Fpa      
Aa^Fpa      , Aa          , Aa          , Aa          , Aa          , Ch          , Gg          , Ggf         , Gg          , Ch          , Ch          , Rp          , Rp          , Rp          , Rp          , Rp          , Rp          , Rp          , Rr          , Rp          , Rp          , Rp          , Ch          , Rp          , Rp          , Rp          , Rp          , Rp          , Ch          , Rp          , Rr          , Rp          , Rp          , Ch          , Ch          , Gg          , Ch          , Aa          , Aa          , Aa          , Aa^Fpa      , Aa^Fpa      
Aa^Fpa      , Aa          , Aa          , Aa          , Aa          , Ch          , Gg          , Gg          , Gg          , Gg^Ve       , Ch          , Rp          , Rp          , Rp          , Rp          , Rp          , Rr          , Rr          , Rp          , Rp          , Rp          , Rp          , Rp          , Rp          , Rp          , Rp          , Rp          , Rp          , Ch          , Ch          , Rr          , Rr          , Rp          , Gg          , Ch          , Gg          , Gg          , Ch          , Aa          , Aa          , Aa^Fpa      , Aa^Fpa      
Aa^Fpa      , Aa          , Aa          , Aa          , Aa          , Ch          , Ch          , Gg          , Gg          , Gg          , Gg          , Ch          , Ch          , Rp          , Rr          , Rr          , Rr          , Rp          , Rp          , Rp          , Rp          , Rp          , Rp          , Rp          , Rp          , Rp          , Ch          , Ch          , Rp          , Rp          , Rp          , Rr          , Rp          , Gg          , Gg^Fet      , Gg          , Gg          , Ch          , Aa          , Aa^Fpa      , Aa^Fpa      , Aa^Fpa      
Aa^Fpa      , Aa          , Aa          , Aa          , Aa          , Aa          , Ch          , Gg          , Gg          , Gg          , Gg          , Gg          , Gg          , Ch          , Rp          , Rr          , Ch          , Ch          , Ch          , Ch          , Ch          , Ch          , Ch          , Ch          , Ch          , Ch          , Gg          , Gg^Ve       , Rp          , Rp          , Ch          , Ch          , Ch          , Rp          , Rp          , Gg          , Gg          , Ch          , Aa          , Aa          , Aa^Fpa      , Aa^Fpa      
Aa^Fpa      , Aa          , Aa          , Aa          , Ch          , Ch          , Aa          , Ch          , Ch          , Gg          , Gg          , Gg          , Rp          , Rp          , Rp          , Rp          , Gg          , Gg^Ve       , Gg          , Gg          , Gg          , Gg          , Gg          , Gg          , Gg          , Gg          , Rp          , Rp          , Rp          , Rp          , Ch          , 5 Kh        , Ch          , Rp          , Gg^Ve       , Ggf         , Gg          , Ch          , Aa          , Aa          , Aa^Fpa      , Aa^Fpa      
Aa^Fpa      , Aa          , Aa          , Ch          , Aa          , Aa          , Aa          , Aa          , Aa          , Ch          , Ch          , Gg          , Rp          , Rp          , Gg          , Gg          , Gg          , Ggf         , Gg          , Gg          , Ch          , Ch          , Ch          , Gg          , Ch          , Gg          , Gg^Ve       , Gg          , Gg          , Rp          , Rp          , Ch          , Ch          , Rp          , Gg          , Gg          , Gg          , Ch          , Aa          , Aa          , Aa^Fpa      , Aa^Fpa      
Aa^Fpa      , Aa          , Chr         , Chr         , Aa          , Aa          , Aa          , Aa          , Aa          , Aa          , Aa          , Ch          , Ch          , Ch          , Ch          , Gg          , Gg          , Gg          , Ch          , Ch          , Aa          , Aa          , Aa          , Ch          , Ch          , Ch          , Ch          , Ch          , Ch          , Rp          , Rp          , Rp          , Rp          , Rp          , Ch          , Ch          , Ch          , Ch          , Aa          , Aa          , Aa^Fpa      , Aa^Fpa      
Aa^Fpa      , Aa          , Chr         , Re          , Re          , Aa          , Aa          , Aa          , Aa          , Aa          , Aa          , Aa          , Aa          , Ch          , Aa          , Ch          , Ch          , Ch          , Aa          , Aa          , Aa          , Aa          , Aa          , Aa          , Aa          , Aa          , Aa          , Aa          , Aa          , Ch          , Aa          , Rp          , Rp          , Ch          , Aa          , Ch          , Aa          , Aa          , Aa^Fpa      , Aa^Fpa      , Aa^Fpa      , Aa^Fpa      
Aa^Fpa      , Aa          , Chr         , Re          , Re          , Aa          , Aa          , Aa          , Ce          , Aa          , Aa          , Aa          , Aa          , Aa          , Aa          , Aa          , Ch          , Aa          , Aa          , Aa          , Aa          , Aa          , Aa          , Aa          , Aa          , Aa          , Aa          , Aa          , Aa          , Aa          , Aa          , Chr         , Rp          , Aa          , Aa          , Aa          , Aa          , Aa          , Aa^Fpa      , Aa^Fpa      , Aa^Fpa      , Aa^Fpa      
Aa^Fpa      , Aa          , Re          , Re          , Aa          , Aa          , Aa          , Ce          , 1 Ke        , Ce          , Aa          , Aa          , Aa          , Aa          , Aa          , Aa          , Ch          , Aa          , Aa          , Aa          , Aa          , Aa          , Aa          , Aa          , Aa          , Aa          , Aa          , Aa          , Aa          , Aa          , Aa          , Chr         , Re          , Aa          , Aa          , Aa          , Aa          , Aa^Vha      , Aa^Fpa      , Aa^Fpa      , Aa^Fpa      , Aa^Fpa      
Aa^Fpa      , Aa          , Aa          , Re          , Aa          , Aa          , Aa          , Ce          , Ce          , Ce          , Aa          , Aa          , Aa          , Aa          , Aa          , Aa          , Ch          , Aa          , Aa          , Aa          , Aa          , Aa          , Aa^Fpa      , Aa^Vha      , Aa^Fpa      , Aa^Fpa      , Aa^Fpa      , Aa^Fpa      , Aa^Fpa      , Aa          , Aa^Fpa      , Aa          , Re          , Aa          , Aa^Fpa      , Aa          , Aa^Fpa      , Aa^Fpa      , Aa^Fpa      , Aa^Fpa      , Ha^Vhha     , Ha          
Aa^Fpa      , Aa          , Aa          , Aa          , Aa^Vha      , Aa^Fpa      , Aa^Fpa      , Aa          , Aa          , Aa          , Aa          , Aa          , Aa          , Aa          , Aa          , Aa          , Ch          , Aa          , Aa          , Aa          , Aa          , Aa          , Aa          , Aa^Fpa      , Aa          , Aa^Fpa      , Aa^Fpa      , Aa^Fpa      , Aa^Fpa      , Aa^Fpa      , Aa^Fpa      , Aa^Fpa      , Re          , Aa^Fpa      , Aa^Fpa      , Aa^Fpa      , Aa^Fpa      , Aa^Fpa      , Aa^Fpa      , Aa^Fpa      , Ha          , Ha          
Aa^Fpa      , Aa          , Aa          , Aa          , Aa^Fpa      , Aa^Fpa      , Aa^Fpa      , Aa^Fpa      , Aa^Vha      , Aa          , Aa          , Aa          , Aa          , Aa          , Aa          , Aa          , Chr         , Aa          , Aa          , Aa          , Aa          , Aa          , Aa          , Aa          , Aa          , Aa^Fpa      , Aa^Fpa      , Aa^Fpa      , Aa          , Aa^Fpa      , Aa          , Aa^Fpa      , Re          , Aa          , Aa          , Aa^Fpa      , Aa^Fpa      , Aa^Fpa      , Aa^Fpa      , Aa^Fpa      , Ha          , Ha          
Aa^Fpa      , Aa          , Aa^Fpa      , Aa^Fpa      , Aa^Fpa      , Aa^Fpa      , Aa^Fpa      , Aa^Fpa      , Aa^Fpa      , Aa          , Aa          , Aa          , Aa          , Aa          , Re          , Re          , Chr         , Re          , Aa          , Aa          , Aa          , Aa          , Aa          , Aa          , Aa          , Aa^Fpa      , Aa^Fpa      , Aa^Fpa      , Ce          , Ce          , Ce          , Aa          , Re          , Aa          , Aa          , Aa^Fpa      , Aa^Fpa      , Aa^Fpa      , Aa^Fpa      , Aa^Fpa      , Ha          , Ha          
Ha          , Aa          , Aa^Fpa      , Aa^Fpa      , Aa^Fpa      , Aa^Fpa      , Aa^Fpa      , Aa^Fpa      , Aa^Fpa      , Aa          , Ha          , Aa          , Aa          , Aa          , Re          , Re          , Chr         , Re          , Re          , Re          , Aa          , Aa          , Aa          , Aa          , Aa          , Aa^Fpa      , Aa^Fpa      , Aa          , Ce          , 6 Ke        , Ce          , Re          , Re          , Aa          , Aa          , Aa          , Aa          , Aa^Fpa      , Aa^Fpa      , Aa^Fpa      , Ha          , Ha          
Ha          , Ha          , Ha          , Aa^Fpa      , Aa^Fpa      , Aa^Fpa      , Aa^Fpa      , Aa^Fpa      , Aa^Fpa      , Aa          , Ha^Vhha     , Aa          , Aa          , Aa          , Re          , Re          , Re          , Re          , Re          , Re          , Aa          , Aa          , Aa          , Aa          , Aa^Fpa      , Aa^Fpa      , Aa^Fpa      , Aa          , Aa          , Ce          , Aa          , Re          , Re          , Aa          , Aa          , Aa          , Aa          , Aa^Fpa      , Aa^Fpa      , Aa^Fpa      , Ha          , Ha          
Ha          , Ha          , Ha          , Ha^Vhha     , Ha          , Aa^Fpa      , Aa^Fpa      , Ha          , Ha          , Ha          , Ha          , Aa          , Aa          , Aa          , Aa          , Re          , Re          , Re          , Re          , Re          , Aa          , Aa          , Aa          , Aa^Fpa      , Aa^Fpa      , Ha          , Ha^Vhha     , Aa          , Aa          , Aa          , Aa          , Re          , Re          , Aa          , Aa          , Aa          , Ha          , Ha^Vhha     , Ha          , Ha          , Ha          , Ha          
Ha          , Ha          , Ha          , Ha          , Ha          , Ha          , Ha          , Ha          , Ha          , Ha          , Ha          , Aa          , Aa          , Aa          , Aa          , Aa          , Aa          , Re          , Re          , Re          , Aa          , Aa          , Aa          , Aa^Fpa      , Aa^Fpa      , Ha          , Ha          , Ha          , Aa          , Aa          , Aa          , Re          , Re          , Aa          , Ha^Vhha     , Ha          , Ha          , Ha          , Ha          , Ha          , Ha          , Ha          
Ha          , Ha          , Ha          , Ha          , Ha          , Ha          , Ha          , Ha          , Ha          , Ha          , Ha          , Ha          , Aa          , Aa          , Aa          , Aa          , Aa          , Re          , Re          , Re          , Aa^Fpa      , Aa^Fpa      , Aa^Fpa      , Aa^Fpa      , Aa^Fpa      , Aa^Fpa      , Aa^Fpa      , Aa^Fpa      , Aa^Fpa      , Aa^Fpa      , Aa^Fpa      , Re          , Re          , Re          , Ha          , Ha          , Ha          , Ha          , Ha          , Ha          , Ha          , Ha          
