border_size=1
usage=map

Mm^Xm       , Mm^Xm       , Mm^Xm       , Ha          , Ha          , Aa          , Ai          , Ww          , Ai          , Aa          , Aa          , Ha          , Ha          , Ha          , Re          , Re          , Re          , Aa^Fpa      , Ha          , Ha          , Ha          , Ha          , Ha          , Ha          , Ha          , Mm^Xm       , Mm^Xm       
Mm^Xm       , Mm^Xm       , Ha          , Ha          , Ha          , Aa          , Ai          , Ai          , Ai          , Aa          , Aa          , Aa^Fpa      , Ha          , Ha          , Ce          , Ce          , Ce          , Aa^Fpa      , Ha          , Ha          , Aa^Fpa      , Ha          , Ha          , Ha          , Ha          , Mm^Xm       , Mm^Xm       
Mm^Xm       , Ha          , Ha          , Ha          , Ha          , Aa          , Ww          , Ai          , Ai          , Aa          , Aa^Fpa      , Aa^Fpa      , Aa^Fpa      , Ha          , Ce          , 1 Ke        , Ce          , Aa^Fpa      , Aa^Fpa      , Aa^Fpa      , Aa^Fpa      , Ha          , Ha          , Ha          , Ha          , Mm^Xm       , Mm^Xm       
Mm^Xm       , Ha          , Ha          , Ha          , Ha          , Aa          , Ai          , Ai          , Ai          , Aa^Fpa      , Aa^Fpa      , Aa^Fpa      , Aa^Fpa      , Aa          , Re          , Ce          , Re          , Re          , Aa          , Aa^Fpa      , Aa^Fpa      , Aa^Fpa      , Ha          , Ha          , Ha          , Ha^Vhha     , Mm^Xm       
Mm^Xm       , Ha          , Ha          , Ha          , Aa          , Aa          , Ai          , Ai          , Ai          , Aa^Fpa      , Aa^Fpa      , Aa^Fpa      , Aa^Fpa      , Aa          , Re          , Re          , Re          , Re          , Aa          , Aa^Fpa      , Aa^Fpa      , Aa^Fpa      , Aa^Fpa      , Ha          , Ha          , Ha          , Mm          
Ha          , Ha          , Ha          , Ha          , Ha          , Aa^Vha      , Ai          , Ai          , Ai          , Aa^Fpa      , Aa^Fpa      , Aa^Fpa      , Aa          , Aa          , Re          , Re          , Re          , Re          , Aa^Vha      , Aa          , Aa^Fpa      , Aa^Fpa      , Aa^Fpa      , Ha          , Ha          , Ha          , Mm          
Ha          , Ha          , Ha          , Ha          , Ha          , Ha          , Ai          , Ww          , Ai          , Ai          , Ai          , Aa^Fpa      , Aa          , Aa          , Aa          , Re          , Re          , Re          , Re          , Aa          , Aa          , Aa^Fpa      , Aa^Fpa      , Aa^Fpa      , Ha          , Ha          , Mm          
Ha          , Ha          , Ha          , Ha          , Ha          , Ha          , Ha          , Ai          , Aa^Fpa      , Ai          , Ai          , Ai          , Ai          , Aa          , Aa          , Re          , Re          , Re          , Re          , Aa          , Aa          , Aa^Fpa      , Aa^Fpa      , Aa^Fpa      , Aa^Fpa      , Ha          , Mm          
Ha          , Ha          , Ha          , Ha          , Ha          , Ha          , Aa^Fpa      , Aa^Fpa      , Aa^Fpa      , Aa^Fpa      , Aa^Fpa      , Ai          , Ai          , Aa          , Aa          , Aa          , Re          , Re          , Re          , Aa          , Aa          , Aa          , Aa^Fpa      , Aa^Fpa      , Aa^Fpa      , Aa^Fpa      , Mm          
Ha          , Ha          , Ha          , Ha          , Ha          , Aa^Fpa      , Aa^Fpa      , Aa^Fpa      , Aa^Fpa      , Aa^Fpa      , Aa          , Ww          , Ai          , Aa          , Aa          , Aa          , Aa          , Re          , Re          , Re          , Re          , Aa          , Aa          , Aa^Fpa      , Aa^Fpa      , Aa^Fpa      , Mm          
Ha          , Ha          , Aa^Fpa      , Ha^Vhha     , Aa^Fpa      , Aa^Fpa      , Aa^Fpa      , Aa^Fpa      , Aa^Fpa      , Aa^Fpa      , Aa          , Ai          , Ai          , Ai          , Aa          , Aa          , Aa          , Re          , Re          , Re          , Re          , Re          , Re          , Aa          , Aa          , Aa^Fpa      , Mm          
Aa^Fpa      , Aa^Fpa      , Aa^Fpa      , Aa^Fpa      , Aa^Fpa      , Aa^Fpa      , Aa^Fpa      , Aa^Fpa      , Aa          , Aa          , Aa          , Ai          , Ai          , Ai          , Ww          , Aa          , Aa          , Aa          , Aa          , Re          , Re          , Re          , Re          , Re          , Aa          , Aa^Fpa      , Mm          
Aa^Fpa      , Aa^Fpa      , Aa^Fpa      , Aa^Fpa      , Aa^Fpa      , Aa^Fpa      , Aa^Fpa      , Aa          , Aa          , Aa          , Aa^Fpa      , Aa^Fpa      , Aa^Fpa      , Ai          , Ai          , Ww          , Ww          , Aa          , Aa          , Aa          , Aa          , Re          , Re          , Re          , Aa          , Aa^Fpa      , Mm          
Aa^Fpa      , Aa^Fpa      , Aa^Fpa      , Aa^Fpa      , Aa^Fpa      , Aa^Fpa      , Aa          , Aa          , Aa          , Aa          , Aa^Fpa      , Aa^Fpa      , Aa^Fpa      , Aa          , Aa          , Ai          , Ai          , Ai          , Ww          , Aa          , Aa          , Re          , Re          , Re          , Aa          , Aa^Fpa      , Mm          
Aa^Fpa      , Aa^Fpa      , Aa^Fpa      , Aa^Fpa      , Aa^Fpa      , Aa^Fpa      , Aa          , Aa          , Aa          , Aa          , Gg          , Aa^Fpa      , Aa          , Aa          , Aa          , Aa          , Aa          , Ai          , Ww          , Ww          , Ai          , Re          , Re          , Re          , Gg          , Aa^Fpa      , Mm          
Aa^Fpa      , Aa^Fpa      , Aa^Fpa      , Aa^Fpa      , Gs^Fp       , Gs^Fp       , Gs^Fp       , Gg          , Gg          , Gg          , Gg          , Gg          , Gg          , Gg          , Gg          , Aa^Vha      , Gg          , Gg          , Gg          , Ww          , Ww          , Re          , Re          , Re          , Chr         , Gs^Fp       , Mm          
Aa^Fpa      , Aa^Fpa      , Gs^Fp       , Gs^Fp       , Gs^Fp       , Gs^Fp       , Gg^Vh       , Gs^Fp       , Gs^Fp       , Gg          , Gs^Fp       , Gg          , Gg          , Gg          , Gg          , Gg          , Gg          , Gg          , Gs^Fp       , Ww          , Ww          , Re          , Re          , Re          , Chr         , 3 Khr       , Mm          
Gs^Fp       , Gs^Fp       , Gs^Fp       , Gs^Fp       , Gg          , Gg          , Gg          , Gg          , Gg          , Gs^Fp       , Gg          , Gs^Fp       , Gg          , Gg          , Gg          , Gg          , Gg          , Gs^Fp       , Gg          , Ww          , Ww^Bw/      , Re          , Re          , Re          , Gg          , Chr         , Gs^Fp       
Gg          , Gs^Fp       , Gg          , Gg          , Gg          , Gg          , Gg          , Gg          , Gg          , Gg          , Gg          , Gg          , Gg          , Gg          , Gg          , Gg          , Gg          , Gg^Vh       , Re          , Ww^Bw/      , Ww          , Chr         , Re          , Re          , Gs^Fp       , Gs^Fp       , Gs^Fp       
Gg          , Gg          , Gg          , Gg          , Chr         , Gg          , Gg          , Gg          , Gg          , Chr         , Gg          , Gg          , Gg          , Gg          , Gg          , Gg          , Re          , Re          , Re          , Ww          , Ww          , Re          , Re          , Re          , Gg          , Gg          , Gs^Fp       
Gg          , Gg          , Gg          , Chr         , 2 Khr       , Chr         , Gg          , Gg          , Gg          , Chr         , Gg          , Gg          , Re          , Re          , Re          , Re          , Re          , Re          , Chr         , Ww          , Ww^Bw/      , Re          , Gg          , Gg          , Gg          , Hh          , Mm          
Gg          , Gg          , Gg          , Chr         , Chr         , Chr         , Gg          , Gg          , Gg          , Gg          , Re          , Re          , Re          , Re          , Re          , Re          , Re          , Re          , Re          , Ww^Bw/      , Ww          , Ww          , Gg          , Gg          , Gg^Vh       , Hh          , Mm          
Gg          , Gg          , Gg          , Gg          , Gg          , Gg          , Gg          , Gg          , Gg          , Gg^Vh       , Re          , Re          , Re          , Re          , Re          , Re          , Gg          , Gg          , Gg          , Gg          , Ww          , Ww          , Gg          , Gg          , Gs^Fp       , Gs^Fp       , Mm          
Gg          , Gg          , Gg          , Gg          , Gg          , Gg          , Gg          , Gg          , Re          , Re          , Re          , Re          , Re          , Re          , Gg          , Gg          , Gg          , Gg          , Gg          , Gg          , Ww          , Ww          , Gg          , Gs^Fp       , Gs^Fp       , Gs^Fp       , Mm          
Gg          , Gg          , Gg          , Chr         , Gg          , Chr         , Gg          , Gg          , Re          , Re          , Re          , Re          , Gg          , Gg          , Gg          , Gg          , Gg          , Gg          , Gg          , Gg          , Ww          , Ww          , Ds          , Gg          , Gg          , Hh          , Mm          
Gs^Fp       , Gs^Fp       , Gs^Fp       , Gg          , Gs^Fp       , Gg          , Gg          , Gg          , Re          , Re          , Re          , Gg^Vh       , Gg          , Gg          , Gg          , Gg          , Gg          , Gg          , Ds          , Ds          , Ww          , Ww          , Ds          , Gg          , Mm          , Mm          , Mm          
Gs^Fp       , Gs^Fp       , Gs^Fp       , Gs^Fp       , Gs^Fp       , Gs^Fp       , Gs^Fp       , Gs^Fp       , Re          , Re          , Re          , Gg          , Gs^Fp       , Gg          , Gg          , Gg          , Gg          , Gg^Vh       , Ds          , Ww          , Ww          , Ww          , Mm          , Mm          , Mm          , Mm          , Mm          
Gs^Fp       , Gs^Fp       , Gs^Fp       , Gs^Fp       , Gs^Fp       , Gg          , Gg          , Gg          , Re          , Re          , Re          , Gs^Fp       , Gg          , Gs^Fp       , Gs^Fp       , Gg          , Gg          , Ds          , Ww          , Ww          , Ww          , Ds          , Mm          , Mm          , Mm          , Mm          , Mm          
Gs^Fp       , Gs^Fp       , Gg          , Gg          , Gg^Fet      , Gg          , Gg          , Gg          , Re          , Re          , Re          , Gs^Fp       , Gs^Fp       , Gs^Fp       , Gs^Fp       , Gs^Fp       , Gs^Fp       , Ds          , Ww          , Ww          , Ww          , Ds          , Mm          , Mm          , Mm          , Mm          , Mm          
Gs^Fp       , Gg          , Gg          , Gg          , Gs^Fp       , Gg          , Gg          , Gg          , Re          , Re          , Re          , Gg          , Gs^Fp       , Gs^Fp       , Ggf         , Gs^Fp       , Gs^Fp       , Ds          , Ds          , Ww          , Ww          , Ds          , Ds          , Mm          , Hh          , Mm          , Mm          
Gs^Fp       , Gg^Ve       , Gg^Fet      , Gg          , Ggf         , Gs^Fp       , Gs^Fp       , Gs^Fp       , Re          , Re          , Re          , Gs^Fp       , Gg          , Gs^Fp       , Gg^Ve       , Ggf         , Gs^Fp       , Gg          , Ds          , Ww          , Ww          , Ww          , Ds          , Gs          , Hh          , Hh          , Mm          
Gs^Fp       , Gs^Fp       , Gs^Fp       , Ggf         , Gs^Fp       , Ggf         , Gs^Fp       , Gs^Fp       , Re          , Re          , Re          , Re          , Re          , Gg          , Gs^Fp       , Gg^Fet      , Gs^Fp       , Gs^Fp       , Gs^Fp       , Ds          , Ww          , Ww          , Ds          , Gs          , Hh          , Mm          , Mm          
Gs^Fp       , Gs^Fp       , Gs^Fp       , Gs^Fp       , Gs^Fp       , Gs^Fp       , Gs^Fp       , Gs^Fp       , Gs^Fp       , Re          , Re          , Re          , Re          , Re          , Gs^Fp       , Gs^Fp       , Gs^Fp       , Gs^Fp       , Gs^Fp       , Ds          , Ww          , Ww          , Ds          , Gs          , Hh          , Mm          , Mm          
Gs^Fp       , Cv          , Gs^Fp       , Gs^Fp       , Gs^Fp       , Cv          , Gs^Fp       , Gs^Fp       , Gs^Fp       , Cv          , Re          , Re          , Re          , Cv          , Re          , Gs^Fp       , Gs^Fp       , Cv          , Gs          , Ds          , Ww          , Ww          , Ds          , Gs          , Hh          , Hh          , Mm          
Gs^Fp       , Gs^Fp       , Gs^Fp       , Gs^Fp       , Gs^Fp       , Gs^Fp       , Gs^Fp       , Gs^Fp       , Gs^Fp       , Gs^Fp       , Gs^Fp       , Re          , Re          , Re          , Re          , Re          , Gs^Fp       , Gs^Fp       , Gs          , Ds          , Ww          , Ww          , Ds          , Gs          , Gs^Fp       , Gs^Fp       , Mm          
Gs^Fp       , Gs^Fp       , Gs^Fp       , Gs^Fp       , Gs^Fp       , Gs^Fp       , Gg^Fet      , Gs^Fp       , Gs^Fp       , Gs^Fp       , Gs^Fp       , Gs^Fp       , Gs^Fp       , Re          , Re          , Re          , Re          , Gs^Fp       , Gs          , Ds          , Ww          , Ww          , Ds          , Gs          , Gs          , Gs^Fp       , Mm          
Gs^Fp       , Gg^Fet      , Gs^Fp       , Gs^Fp       , Gs^Fp       , Gs^Fp       , Gs^Fp       , Gs^Fp       , Gs^Fp       , Gs^Fp       , Gg^Fet      , Gs^Fp       , Gs^Fp       , Gg^Ve       , Re          , Re          , Re          , Gs^Fp       , Gs          , Ds          , Ww          , Ww          , Ww          , Ds          , Gs^Ft       , Gs^Fp       , Mm          
Gs^Fp       , Gs^Fp       , Gs^Fp       , Gs^Fp       , Gs^Fp       , Gs^Fp       , Gs^Fp       , Gs^Fp       , Gs^Fp       , Gs^Fp       , Gs^Fp       , Gs^Fp       , Gs^Fp       , Gs^Fp       , Re          , Re          , Re          , Gs^Fp       , Gs          , Ds          , Ww          , Ww          , Ww          , Ds          , Gs          , Gs^Fp       , Mm          
Gs^Fp       , Gs^Fp       , Gs^Fp       , Gs^Fp       , Cv          , Cv          , Cv          , Gs^Fp       , Gs^Fp       , Gs^Fp       , Gs^Fp       , Gs^Fp       , Gs^Fp       , Gs^Fp       , Re          , Re          , Re          , Gs^Fp       , Gs^Ft       , Ds          , Ww          , Ww          , Ww          , Ds          , Gs          , Hh          , Mm          
Gs^Fp       , Gs^Fp       , Gs^Fp       , Gs^Fp       , Gs^Fp       , 4 Kv        , Ggf         , Ggf         , Ggf         , Gs^Fp       , Gs^Fp       , Gs^Fp       , Gs^Fp       , Gs^Fp       , Re          , Re          , Re          , Gs^Fp       , Gs^Fp       , Gs          , Gs^Ft       , Ww          , Ww          , Ds          , Gs          , Hh          , Mm          
Gs^Fp       , Gs^Fp       , Gg^Fet      , Gs^Fp       , Gs^Fp       , Gs^Fp       , Gg^Ve       , Ggf         , Ggf         , Gg^Ve       , Gs^Fp       , Gs^Ft       , Gs^Fp       , Gs^Fp       , Re          , Re          , Re          , Gs^Fp       , Gs^Fp       , Gs          , Ds          , Ww          , Ww          , Ds          , Gs^Ft       , Hh          , Mm          
Gs^Ft       , Gs^Fp       , Gs^Fp       , Gs^Fp       , Gs^Fp       , Gs^Fp       , Gs^Fp       , Gs^Fp       , Gs^Fp       , Gs^Fp       , Gs^Fp       , Gs^Fp       , Gs^Fp       , Gs^Fp       , Re          , Re          , Re          , Gg^Fet      , Gs^Fp       , Gs          , Ds          , Ww          , Ww          , Ds          , Gs          , Hh          , Mm          
