border_size=1
usage=map

Xu          , Xu          , Xu          , Xu          , Xu          , Xu          , Xu          , Xu          , Xu          , Xu          , Xu          , Xu          , Xu          , Xu          , Xu          , Ql          , Ql          , Ql          , Ql          , Ql          , Ql          , Xu          , Xu          , Xu          , Xu          , Xu          , Xu          , Xu          , Xu          , Xu          , Xu          , Xu          
Xu          , Xu          , Xu          , Xu          , Xu          , Xu          , Ql          , Xu          , Xu          , Xu          , Ql          , Ql          , Ql          , Xu          , Xu          , Ql          , Ql          , Ql          , Ql          , Ql          , Ql          , Xu          , Xu          , Xu          , Xu          , Xu          , Xu          , Xu          , Xu          , Xu          , Xu          , Xu          
Xu          , Xu          , Xu          , Xu          , Xu          , Ql          , Ql          , Ql          , Ql          , Ql          , Ql          , Ql          , Ql          , Ql          , Ql          , Ql          , Ql          , Ql          , Ql          , Ql          , Ql          , Ql          , Ql          , Ql          , Ql          , Xu          , Ql          , Xu          , Ql          , Xu          , Xu          , Xu          
Xu          , Xu          , Xu          , Xu          , Ql          , Ql          , Ql          , Ql          , Ql          , Ql          , Ql          , Ql          , Ql          , Ql          , Ql          , Ql          , Ql          , Ql          , Ql          , Ql          , Ql          , Ql          , Ql          , Ql          , Ql          , Ql          , Ql          , Ql          , Ql          , Ql          , Ql          , Xu          
Xu          , Xu          , Ql          , Ql          , Ql          , Ql          , Ql          , Ql          , Ql          , Ql          , Ql          , Ql          , Ql          , Ql          , Ql          , Ql          , Uu          , Ql          , Uu          , Ql          , Uu          , Ql          , Ql          , Ql          , Ql          , Ql          , Ql          , Ql          , Ql          , Ql          , Ql          , Xu          
Xu          , Xu          , Ql          , Ql          , Ql          , Ql          , Ql          , Ql          , Ql          , Ql          , Xu          , Xu          , Uu          , Cud         , Rr          , Uu          , Uu          , Uu          , Uu          , Uu          , Rr          , Cud         , Uu          , Uu          , Xu          , Uu          , Uu          , Ql          , Ql          , Ql          , Ql          , Xu          
Xu          , Ql          , Ql          , Ql          , Ql          , Ql          , Ql          , Ql          , Ql          , Xu          , Xu          , Uu          , Uu          , Uu          , Uu          , Rr          , Rr          , Rr          , Rr          , Rr          , Uu          , Uu          , Uu          , Uu          , Uu          , Xu          , Uu          , Uu          , Ql          , Ql          , Ql          , Xu          
Xu          , Ql          , Ql          , Ql          , Ql          , Ql          , Ql          , Ql          , Ql          , Xu          , Xu          , Uu          , Uu          , Uu          , Rr          , Rr          , Rr          , Cud         , Rr          , Rr          , Rr          , Uu          , Uu          , Uu          , Uu          , Xu          , Uu          , Uu          , Ql          , Ql          , Ql          , Xu          
Xu          , Ql          , Ql          , Ql          , Ql          , Ql          , Ql          , Ql          , Ql          , Xu          , Xu          , Uu          , Uu          , Rr          , Uu          , Uu          , Rr          , Rr          , Rr          , Uu          , Uu          , Rr          , Uu          , Uu          , Uu          , Xu          , Uu          , Uu          , Ql          , Ql          , Ql          , Xu          
Xu          , Ql          , Ql          , Ql          , Ql          , Ql          , Ql          , Ql          , Ql          , Xu          , Xu          , Uu          , Cud         , Rr          , Uu          , Uu          , Rr          , Cud         , Rr          , Uu          , Uu          , Rr          , Cud         , Uu          , Uu          , Xu          , Uu          , Uu          , Ql          , Ql          , Ql          , Ql          
Xu          , Ql          , Ql          , Ql          , Ql          , Ql          , Ql          , Ql          , Ql          , Ql          , Xu          , Xu          , Uu          , Uu          , Uu          , Uu          , Cud         , 2 Kud       , Cud         , Uu          , Uu          , Uu          , Uu          , Uu          , Xu          , Xu          , Uu          , Uu          , Uu          , Ql          , Ql          , Ql          
Xu          , Ql          , Ql          , Ql          , Ql          , Ql          , Ql          , Ql          , Ql          , Ql          , Xu          , Xu          , Uu          , Uu          , Uu          , Uu          , Rr          , Rr          , Rr          , Uu          , Uu          , Uu          , Uu          , Uu          , Xu          , Xu          , Xu          , Uu          , Ql          , Ql          , Ql          , Ql          
Xu          , Ql          , Ql          , Ql          , Ql          , Ql          , Ql          , Ql          , Ql          , Ql          , Xu          , Xu          , Uu^Vud      , Uu          , Cud         , Uu          , Rr          , Rr          , Rr          , Uu          , Cud         , Uu          , Xu          , Xu          , Xu          , Xu          , Xu          , Xu          , Ql          , Ql          , Ql          , Xu          
Xu          , Ql          , Ql          , Ql          , Ql          , Ql          , Ql          , Ql          , Xu          , Xu          , Xu          , Xu          , Xu          , Uu          , Uu          , Uu          , Rr          , Rr          , Rr          , Uu          , Uu          , Uu^Vud      , Xu          , Xu          , Xu          , Xu          , Xu          , Xu          , Ql          , Ql          , Ql          , Ql          
Xu          , Ql          , Ql          , Ql          , Ql          , Ql          , Ql          , Ql          , Xu          , Xu          , Xu          , Xu          , Xu          , Uu          , Uu          , Uu          , Rr          , Rr          , Rr          , Uu          , Xu          , Xu          , Xu          , Xu          , Xu          , Xu          , Ql          , Ql          , Ql          , Ql          , Ql          , Ql          
Xu          , Ql          , Ql          , Ql          , Qxu         , Ql          , Qxu         , Ql          , Qxu         , Xu          , Xu          , Xu          , Xu          , Xu          , Xu          , Cud         , Rr          , Rr          , Rr          , Cud         , Xu          , Xu          , Xu          , Xu          , Xu          , Xu          , Ql          , Ql          , Ql          , Ql          , Ql          , Ql          
Xu          , Xu          , Qxu         , Qxu         , Qxu         , Qxu         , Qxu         , Qxu         , Qxu         , Qxu         , Qxu         , Xu          , Xu          , Xu          , Uu          , Uu          , Rr          , Rr          , Rr          , Xu          , Xu          , Xu          , Xu          , Xu          , Qxu         , Qxu         , Qxu         , Qxu         , Qxu         , Ql          , Ql          , Xu          
Qxu         , Qxu         , Qxu         , Qxu         , Qxu         , Qxu         , Qxu         , Qxu         , Qxu         , Qxu         , Qxu         , Qxu         , Qxu         , Uu          , Uu          , Uu          , Rr          , Rr          , Rr          , Uu          , Uu          , Uu^Vu       , Uu          , Qxu         , Qxu         , Qxu         , Qxu         , Qxu         , Qxu         , Qxu         , Qxu         , Qxu         
Qxu         , Qxu         , Qxu         , Qxu         , Xu          , Xu          , Xu          , Qxu         , Xu          , Qxu         , Qxu         , Qxu         , Qxu         , Uu          , Uu          , Uu          , Rr          , Rr          , Rr          , Uu          , Uu          , Uu          , Uu          , Qxu         , Qxu         , Qxu         , Qxu         , Qxu         , Qxu         , Qxu         , Qxu         , Qxu         
Qxu         , Qxu         , Qxu         , Qxu         , Xu          , Xu          , Xu          , Xu          , Xu          , Xu          , Xu          , Qxu         , Uh          , Uu          , Uu          , Uu          , Rr          , Rr          , Rr          , Uu          , Uu          , Uu          , Cud         , Uu          , Uu          , Qxu         , Qxu         , Qxu         , Qxu         , Qxu         , Qxu         , Qxu         
Qxu         , Qxu         , Qxu         , Xu          , Xu          , Xu          , Xu          , Xu          , Xu          , Xu          , Xu          , Xu          , Cud         , Uu          , Re          , Uu          , Xu          , Xu          , Xu          , Uu          , Uu          , Uu          , Uu          , Uu          , Uu          , Uh          , Qxu         , Qxu         , Qxu         , Qxu         , Qxu         , Qxu         
Qxu         , Qxu         , Qxu         , Qxu         , Uh          , Uu          , Uu          , Uu          , Uu          , Uh          , Uu          , Uu          , Uu          , Uu          , Uu          , Cud         , Xu          , Xu          , Xu          , Cud         , Uu          , Re          , Uu          , Uu          , Uu          , Uh          , Qxu         , Qxu         , Qxu         , Qxu         , Qxu         , Qxu         
Qxu         , Qxu         , Qxu         , Qxu         , Uh          , Uu          , Qxu         , Qxu         , Qxu         , Uu          , Uu          , Uu          , Uu          , Uu          , Re          , Uu          , Uu          , Xu          , Uu          , Uu          , Uu          , Uu          , Re          , Uu          , Uu          , Uu          , Uu          , Qxu         , Qxu         , Qxu         , Qxu         , Qxu         
Qxu         , Qxu         , Qxu         , Qxu         , Qxu         , Qxu         , Qxu         , Qxu         , Uu          , Uu          , Uu          , Uu          , Cud         , Uu          , Re          , Uu          , Uu          , Uu          , Uu          , Uu          , Uu          , Uu          , Re          , Uh          , Uh          , Uu          , Uu          , Uu          , Qxu         , Qxu         , Qxu         , Qxu         
Qxu         , Qxu         , Qxu         , Qxu         , Qxu         , Qxu         , Uh          , Uh          , Uh          , Uu          , Uu          , Uu          , Uu          , Re          , Uu          , Uu          , Uu          , Uu          , Uu          , Uu          , Uu          , Uu          , Re          , Uh          , Uu          , Uu          , Uu          , Uu          , Qxu         , Qxu         , Qxu         , Qxu         
Qxu         , Qxu         , Qxu         , Qxu         , Qxu         , Uu          , Uh          , Uh          , Uh          , Uu          , Uu          , Uu          , Uu          , Re          , Uu          , Uu          , Qxu         , Qxu         , Qxu         , Uu          , Uu          , Uu          , Re          , Uu          , Uu          , Uu          , Uu          , Uu          , Uu          , Qxu         , Qxu         , Qxu         
Qxu         , Qxu         , Qxu         , Uu          , Qxu         , Qxu         , Qxu         , Uu          , Uu          , Uu          , Qxu         , Qxu         , Uu          , Re          , Uu          , Uu          , Qxu         , Qxu         , Qxu         , Uu          , Uu          , Uu          , Re          , Uu          , Uu          , Uu          , Uh          , Uh          , Uu          , Qxu         , Qxu         , Qxu         
Qxu         , Qxu         , Qxu         , Uu          , Uu          , Qxu         , Uu          , Uu          , Uu          , Uu          , Xu          , Xu          , Xu          , Re          , Uu          , Uu          , Uu          , Qxu         , Uu          , Uu          , Re          , Re          , Uu          , Uu          , Uu          , Uu          , Uh          , Uh          , Uu          , Qxu         , Qxu         , Qxu         
Qxu         , Qxu         , Qxu         , Uu          , Uu          , Uu          , Uu          , Re          , Uu          , Uu          , Uu^Vu       , Xu          , Re          , Re          , Uh          , Uu          , Uu          , Uu          , Uu          , Uu          , Re          , Uu          , Uu          , Uu          , Uu          , Uu          , Uu          , Uu          , Uu          , Qxu         , Qxu         , Qxu         
Qxu         , Qxu         , Qxu         , Uh          , Uu          , Uu          , Uu          , Re          , Uu          , Uu          , Uu          , Uu          , Uu          , Re          , Uh          , Uu          , Uu          , Uu          , Re          , Re          , Uu          , Uu          , Uu          , Uu          , Qxu         , Qxu         , Qxu         , Uu          , Qxu         , Qxu         , Qxu         , Qxu         
Qxu         , Qxu         , Qxu         , Uh          , Uu          , Uu          , Uu          , Re          , Re          , Uu          , Re          , Uu          , Uu          , Re          , Cud         , Re          , Re          , Uh          , Re          , Uh          , Uu          , Uu          , Uu          , Uu          , Uh          , Qxu         , Qxu         , Uu          , Qxu         , Qxu         , Qxu         , Qxu         
Qxu         , Qxu         , Qxu         , Uu          , Uu          , Uu          , Uu          , Uu          , Uu^Vu       , Re          , Re          , Re          , Uu          , Re          , Re          , Re          , Uu          , Re          , Uu          , Uu          , Uu          , Uu          , Re          , Uh          , Uh          , Uu          , Uu          , Uu          , Qxu         , Qxu         , Qxu         , Qxu         
Qxu         , Qxu         , Qxu         , Uu          , Uu          , Uu          , Uh          , Uh          , Uh          , Uh          , Uu          , Re          , Re          , Re          , Re          , Uu          , Uu          , Uu          , Xu          , Xu          , Xu          , Uu          , Uh          , Uh          , Uh          , Uu          , Uu          , Uu          , Qxu         , Qxu         , Qxu         , Qxu         
Qxu         , Qxu         , Qxu         , Uu          , Uu          , Uu          , Uu          , Uh          , Qxu         , Uh          , Uu          , Uu          , Uu          , Re          , Re          , Uu          , Uu          , Uu^Vu       , Xu          , Xu          , Xu          , Uu          , Uu          , Uh          , Uu          , Uu          , Uu          , Uu          , Qxu         , Qxu         , Qxu         , Qxu         
Qxu         , Qxu         , Qxu         , Uu          , Uu          , Uu          , Uu          , Qxu         , Qxu         , Qxu         , Qxu         , Uu          , Uu          , Uh          , Re          , Uu          , Uu          , Uu          , Uu          , Xu          , Xu          , Uu          , Uu          , Uu          , Uu          , Uu          , Uu          , Uu          , Uu          , Qxu         , Qxu         , Qxu         
Qxu         , Qxu         , Qxu         , Uu          , Uu          , Uu          , Uu          , Qxu         , Qxu         , Qxu         , Uu          , Uu          , Uu          , Re          , Uu          , Uu          , Uu          , Uu          , Uu          , Uu          , Uu          , Uu          , Uu          , Uu          , Uu          , Uu          , Uu          , Uu          , Qxu         , Qxu         , Qxu         , Qxu         
Qxu         , Qxu         , Qxu         , Uu          , Uu          , Uu          , Uu          , Uu          , Uu          , Uu          , Uu          , Uu          , Uh          , Re          , Uu          , Uu          , Uh          , Uh          , Uh          , Uu          , Uu          , Uh          , Uh          , Uu          , Uh          , Uu          , Uu          , Uu          , Qxu         , Qxu         , Qxu         , Qxu         
Qxu         , Qxu         , Qxu         , Qxu         , Uu          , Uu          , Uu          , Uu          , Uu          , Uu          , Uu          , Uh          , Re          , Re          , Uu          , Uu          , Uu          , Uh          , Uu          , Uu          , Uu          , Uh          , Uh          , Uh          , Uu          , Uu          , Uu          , Uu          , Qxu         , Qxu         , Qxu         , Qxu         
Qxu         , Qxu         , Qxu         , Qxu         , Uu          , Uu          , Uu          , Uu          , Uu          , Uu          , Uu          , Uh          , Re          , Uu          , Uu          , Uu          , Uu          , Uu          , Uu          , Uu          , Re          , Uu          , Uu          , Uu          , Uu          , Uu          , Uu          , Uu          , Qxu         , Qxu         , Qxu         , Qxu         
Qxu         , Qxu         , Qxu         , Uh          , Uh          , Uu          , Uu          , Uh          , Uh          , Uu          , Uu          , Uu          , Re          , Uu          , Uu          , Uu^Vu       , Uu          , Uu          , Uu          , Re          , Uu          , Uu          , Qxu         , Uu          , Uu          , Uu          , Uu          , Uu          , Qxu         , Qxu         , Qxu         , Qxu         
Qxu         , Qxu         , Qxu         , Uh          , Uh          , Uu          , Uu          , Uh          , Qxu         , Qxu         , Uu          , Uu          , Re          , Uu          , Uu          , Uu          , Cud         , Uu          , Uu          , Re          , Uu          , Qxu         , Qxu         , Uu          , Uu          , Uu          , Uu          , Uu          , Qxu         , Qxu         , Qxu         , Qxu         
Qxu         , Qxu         , Qxu         , Qxu         , Uu          , Uu          , Uu          , Uu          , Uu          , Qxu         , Uu          , Uu          , Uu          , Uu          , Uu          , Uu          , Uu          , Uu          , Uu          , Re          , Uu          , Qxu         , Qxu         , Qxu         , Uu          , Uu          , Uu          , Uu          , Uu          , Qxu         , Qxu         , Qxu         
Qxu         , Qxu         , Qxu         , Uu          , Uu          , Uu          , Uu          , Uu          , Uu          , Uu          , Uu          , Re          , Uu          , Uu          , Uu          , Uu          , Uh          , Uu          , Uu          , Re          , Uu          , Uu          , Uu          , Uu          , Uu          , Uu          , Uu          , Uu          , Uu          , Qxu         , Qxu         , Qxu         
Qxu         , Qxu         , Qxu         , Uu          , Uu          , Uu          , Uu          , Uu          , Uu          , Uu          , Uu          , Re          , Uu          , Uu          , Uh          , Uh          , Qxu         , Qxu         , Qxu         , Re          , Re          , Uu          , Uu          , Uh          , Xu          , Uu          , Uu          , Uu          , Uu          , Qxu         , Qxu         , Qxu         
Qxu         , Qxu         , Uu          , Uu          , Qxu         , Uu          , Uu          , Uu          , Uu          , Uu          , Uu          , Re          , Re          , Uu          , Xu          , Xu          , Xu          , Qxu         , Uu          , Uu          , Re          , Uu          , Uu          , Uh          , Uu^Vu       , Xu          , Uu          , Uu          , Uu          , Qxu         , Qxu         , Qxu         
Qxu         , Qxu         , Uu          , Uu          , Uu          , Qxu         , Qxu         , Uh          , Uh          , Uu          , Uu          , Uu          , Re          , Uu          , Uu          , Xu          , Uh          , Uh          , Uu          , Uu          , Re          , Uu          , Uu          , Uu          , Uu          , Uu          , Uu          , Uu          , Uu          , Qxu         , Qxu         , Qxu         
Qxu         , Qxu         , Uu          , Uu          , Uu          , Qxu         , Qxu         , Qxu         , Uh          , Uu          , Uu          , Uu          , Uu          , Uu          , Uu          , Uu          , Uu          , Uu          , Uu          , Re          , Uu          , Uu          , Uu          , Uu          , Uu          , Uu          , Uu          , Uu          , Qxu         , Qxu         , Qxu         , Qxu         
Qxu         , Qxu         , Uu          , Uu          , Uu          , Uh          , Uh          , Qxu         , Uh          , Uu          , Uu          , Uu          , Uu          , Uu          , Re          , Uu          , Uu          , Uu          , Uu          , Uu          , Uu          , Uu          , Uu          , Uu          , Uu          , Uu          , Uu          , Qxu         , Qxu         , Qxu         , Qxu         , Qxu         
Qxu         , Qxu         , Uu          , Uu          , Uu          , Uu          , Uu          , Uh          , Uh          , Uu          , Uu          , Uu          , Uu          , Re          , Uu          , Re          , Ce          , Ce          , Ce          , Re          , Uu          , Uu          , Uu          , Uu          , Uu          , Uu          , Uu          , Uu          , Qxu         , Qxu         , Qxu         , Qxu         
Qxu         , Qxu         , Qxu         , Uu          , Uu          , Uu          , Uu          , Uu          , Uu          , Uu          , Uu          , Uu          , Uu          , Uu          , Uu          , Uu          , Uu          , 1 Ke        , Uu          , Re          , Uu          , Uu          , Uu          , Uu          , Uu          , Uu          , Xu          , Uu          , Qxu         , Qxu         , Qxu         , Qxu         
Qxu         , Qxu         , Xu          , Uu          , Xu          , Uu          , Uu          , Uu          , Uu          , Uu          , Uu          , Uu          , Uu          , Uu          , Uu          , Uu          , Uu          , Uu          , Uu          , Uu          , Uu          , Uu          , Uu          , Uu          , Xu          , Xu          , Xu          , Xu          , Xu          , Qxu         , Qxu         , Qxu         
Qxu         , Qxu         , Xu          , Xu          , Xu          , Xu          , Xu          , Uu          , Uu          , Uu          , Uu^Ii       , Uu^Ii       , Uu^Ii       , Uh^Ii       , Uh^Ii       , Uh^Ii       , Uh^Ii       , Uu^Ii       , Uu^Ii       , Uu^Ii       , Uu^Ii       , Uu^Ii       , Uu^Ii       , Uu^Ii       , Uu          , Xu          , Xu          , Xu          , Xu          , Qxu         , Qxu         , Qxu         
